1 1 1 1 1 1 1 1 1 1 1 1 1 1 1 1 1 1 1 1 1 1 1 1 1 1 1 1 1 1 1 1 33 21 14 13 26 119 121 1 1 1 1 1 1 1 1 1 1 1 
1 1 1 1 1 1 1 1 1 1 1 1 1 1 1 1 1 1 1 1 1 1 1 1 1 1 1 1 1 1 118 120 33 21 14 13 26 1 1 1 1 1 1 1 1 1 1 1 1 1 
1 1 1 1 1 1 1 1 1 118 120 1 1 1 1 1 1 118 120 1 1 1 1 1 1 1 1 1 1 1 119 121 33 21 14 13 26 1 1 1 1 1 1 1 1 1 1 1 1 1 
1 1 1 1 1 1 1 1 1 119 121 118 120 1 1 1 1 119 121 1 1 1 118 120 1 1 1 1 1 1 1 1 33 21 14 13 26 1 1 118 120 1 1 1 1 1 1 1 1 1 
1 1 1 1 118 120 1 1 1 1 1 119 121 1 118 120 1 1 1 1 1 1 119 121 1 1 118 120 1 1 1 1 33 21 14 13 26 1 1 119 121 1 1 1 118 120 1 1 1 1 
1 1 1 1 119 121 1 118 120 1 1 1 1 1 119 121 1 118 120 1 1 1 1 1 1 1 119 121 1 1 1 1 33 21 14 13 26 1 1 1 1 1 1 1 119 121 1 1 1 1 
1 1 1 1 1 1 1 119 121 29 27 27 27 27 28 1 1 119 121 29 27 27 27 27 28 1 1 1 29 27 27 27 24 21 14 13 26 1 118 120 1 1 1 1 1 1 1 1 1 1 
1 1 1 1 1 118 120 1 29 24 1 1 1 1 25 27 27 27 27 24 46 44 44 45 25 27 27 27 24 1 1 1 1 21 14 13 25 28 119 121 1 1 118 120 1 1 1 1 1 1 
1 118 120 1 1 119 121 29 24 1 1 1 4 1 1 1 46 44 44 44 40 43 43 41 44 44 44 44 45 1 1 1 4 21 14 13 4 25 27 27 28 1 119 121 1 1 1 1 1 1 
1 119 121 1 1 1 29 24 1 128 134 129 4 4 1 1 50 43 43 43 43 43 43 43 43 43 81 52 53 1 1 4 4 21 14 13 4 4 1 1 25 28 1 1 1 1 1 1 1 1 
1 1 1 1 1 1 33 1 1 130 135 131 4 4 4 1 49 47 47 47 47 47 47 47 47 47 47 47 48 1 4 4 4 21 14 13 4 4 4 1 1 25 28 1 1 118 120 1 118 120 
1 1 1 1 118 120 33 126 1 132 136 133 4 4 4 4 1 4 4 1 4 4 4 4 4 1 4 4 1 4 4 4 4 21 14 13 4 4 4 4 1 1 25 28 1 119 121 1 119 121 
1 1 1 1 119 121 33 101 1 17 15 15 15 15 15 15 15 15 15 15 15 15 15 15 15 15 15 15 15 15 15 15 15 11 14 12 15 15 15 15 15 16 1 26 1 1 1 1 1 1 
1 1 1 1 1 1 33 102 1 21 14 14 14 14 14 14 14 14 14 14 14 14 14 14 14 14 14 14 14 14 14 14 14 14 14 14 14 14 14 14 14 13 1 26 1 1 1 1 1 1 
1 1 1 1 1 1 33 127 1 20 18 18 18 18 18 18 18 18 18 18 18 9 14 10 18 18 18 18 18 18 18 18 18 18 18 18 18 18 18 18 18 19 1 26 1 1 1 1 1 1 
1 1 118 120 1 1 33 1 1 46 44 44 44 44 44 44 44 45 1 1 1 21 14 13 4 4 4 4 4 4 4 4 4 4 1 4 4 4 4 4 4 4 4 26 1 1 118 120 1 1 
1 1 119 121 1 1 33 1 46 40 43 43 43 43 43 43 43 41 45 1 1 21 14 13 4 1 1 1 1 1 4 1 1 4 1 4 1 1 1 1 1 1 4 25 28 1 119 121 1 1 
1 1 1 1 1 1 33 1 50 43 43 43 43 43 43 43 43 43 41 45 1 21 14 13 4 1 4 4 4 4 4 1 4 4 1 4 1 4 4 4 4 1 4 4 26 1 1 1 1 1 
1 1 1 1 1 1 33 1 50 43 43 39 38 39 38 43 43 43 43 42 1 21 14 13 4 1 1 1 1 1 4 1 1 4 1 1 1 1 1 1 4 1 4 4 26 1 1 1 1 1 
1 1 1 1 1 29 24 46 40 43 106 41 40 42 49 38 106 43 43 42 1 21 14 13 4 1 4 4 4 4 4 4 1 1 1 4 4 4 1 1 4 4 4 4 26 1 1 1 118 120 
1 1 1 1 1 33 1 50 43 39 38 43 43 42 78 50 43 43 43 41 45 21 14 13 4 1 1 1 1 1 4 1 1 4 1 1 1 4 4 4 4 1 4 4 26 1 1 1 119 121 
1 1 1 118 120 33 1 50 43 41 40 43 39 48 77 49 38 43 43 43 42 21 14 13 4 4 4 4 4 1 4 1 4 4 4 1 1 1 1 4 1 1 4 4 26 1 1 1 1 1 
1 1 1 119 121 33 1 50 43 43 43 43 42 1 1 1 50 43 43 43 42 21 14 13 4 1 1 1 4 1 4 1 4 1 1 1 1 4 1 4 1 4 4 23 31 118 120 1 1 1 
1 1 1 1 1 32 22 49 38 43 43 43 42 1 1 1 51 52 52 52 53 21 14 13 4 1 1 1 1 1 1 1 4 1 4 4 4 4 1 4 4 4 23 31 1 119 121 1 1 1 
1 1 1 1 1 1 32 22 49 38 43 106 41 45 1 1 50 43 43 43 42 21 14 13 4 1 4 4 4 4 4 1 4 1 4 23 22 4 1 4 4 23 31 1 1 1 1 1 1 1 
1 1 1 1 1 1 1 32 22 50 43 43 43 42 4 46 40 43 43 43 42 21 14 13 4 1 4 23 30 22 4 4 4 4 4 25 24 4 1 4 4 26 1 1 1 1 1 1 1 1 
1 1 1 1 1 1 118 120 33 50 43 43 43 41 44 40 43 39 38 43 42 21 14 13 4 1 4 25 27 24 4 1 1 1 4 4 4 4 1 4 4 26 1 1 1 1 1 1 1 1 
1 1 1 1 1 1 119 121 33 49 38 43 43 43 43 43 106 41 40 39 48 21 14 13 4 1 4 4 4 4 4 1 7 1 1 1 1 1 1 4 4 26 1 1 1 1 1 1 1 118 
1 1 1 1 1 1 1 1 33 1 49 38 43 43 43 43 43 43 39 48 1 21 14 13 4 1 1 1 1 1 4 1 1 1 4 4 4 4 4 4 4 26 1 1 1 1 1 1 1 119 
1 1 1 118 120 1 1 1 33 1 1 49 47 47 47 47 47 47 48 1 1 21 14 13 4 1 4 4 4 4 4 4 4 4 4 23 30 30 30 22 4 26 1 118 120 1 1 1 1 1 
1 1 1 119 121 1 1 1 33 1 1 1 1 1 1 1 1 1 1 1 1 21 14 13 4 1 1 1 1 4 1 1 1 1 1 26 4 4 4 33 4 26 1 119 121 1 1 1 1 1 
1 1 1 1 1 1 1 1 33 1 1 1 1 1 1 1 1 1 1 1 1 21 14 13 4 1 1 4 1 1 1 4 4 4 4 25 27 27 27 24 4 26 1 1 1 1 1 1 1 1 
1 1 1 1 1 1 1 1 33 1 1 1 1 1 1 1 1 1 1 1 1 21 14 13 4 4 4 4 4 4 4 4 4 4 4 4 4 4 4 4 4 26 1 1 1 1 1 1 1 1 
1 1 1 1 1 1 1 1 33 1 79 1 1 1 1 1 1 1 1 79 1 21 14 13 1 79 1 1 1 1 1 1 1 1 1 1 1 1 1 1 1 26 1 1 1 1 1 1 1 1 
1 1 1 1 1 1 1 29 24 4 77 4 1 1 1 1 1 1 4 77 1 21 14 13 1 77 4 1 1 1 1 1 1 1 1 1 1 1 1 1 1 26 1 1 1 1 1 1 1 1 
1 1 1 1 1 1 29 24 29 27 27 27 27 27 27 27 27 27 28 4 22 21 14 13 23 4 1 1 1 1 1 1 1 1 1 29 27 27 27 27 28 25 28 1 1 1 1 1 1 1 
1 1 1 1 1 29 24 29 24 17 15 15 15 15 15 15 15 16 25 27 24 20 18 19 25 28 1 1 1 29 27 27 27 27 27 24 17 15 15 16 25 28 25 28 1 1 1 1 1 1 
1 1 1 1 29 24 29 24 17 11 14 14 14 14 14 14 14 12 15 15 15 15 15 15 16 25 27 27 27 24 17 15 15 15 15 15 11 14 14 12 16 25 28 25 28 1 1 1 1 1 
1 1 1 29 24 29 24 17 11 14 14 14 14 14 14 14 14 14 14 14 14 14 14 14 12 15 15 15 15 15 11 14 14 14 14 14 14 14 14 14 12 16 25 28 25 28 1 1 1 1 
27 27 27 24 29 24 17 11 14 14 14 14 14 14 14 14 14 14 14 14 14 14 14 14 14 14 14 14 14 14 14 14 14 14 14 14 14 14 14 14 14 12 16 25 28 25 27 27 27 27 
27 27 27 27 24 17 11 14 14 14 14 14 14 14 14 14 14 14 14 14 14 14 14 14 14 14 14 14 14 14 14 14 14 14 14 14 14 14 14 14 14 14 12 16 25 27 27 27 27 27 
15 15 15 15 15 11 65 63 63 63 63 63 66 14 14 14 14 14 14 65 63 63 63 63 63 63 66 14 14 14 14 14 14 14 65 63 63 63 63 63 63 66 14 12 15 15 15 15 15 15 
63 63 63 63 63 63 64 43 43 43 43 43 62 63 63 63 63 63 63 64 43 43 43 43 43 43 62 63 63 63 63 63 63 63 64 43 43 43 43 43 43 62 63 63 63 63 63 63 63 63 
43 43 43 43 43 43 43 43 43 43 43 43 43 43 43 43 43 43 43 43 43 43 43 43 43 43 43 43 43 43 43 43 43 43 43 43 57 59 43 43 43 43 43 43 43 43 43 43 43 43 
43 43 43 43 57 58 58 59 43 43 43 43 43 43 43 43 43 43 43 43 43 43 43 43 43 43 43 43 43 43 43 43 43 43 43 43 62 64 43 43 57 59 43 43 43 43 43 43 43 43 
43 43 43 43 60 14 14 61 43 43 43 43 43 43 43 43 43 43 43 43 43 43 43 43 57 58 58 59 43 43 43 43 43 43 43 43 43 43 57 59 62 64 43 43 43 43 43 43 43 43 
43 43 43 43 62 63 63 64 43 43 43 43 43 43 43 43 57 59 43 43 43 43 43 43 62 63 66 61 43 43 43 43 43 43 43 43 43 43 62 64 43 43 43 43 43 43 43 43 43 43 
43 43 43 43 43 43 43 43 43 43 43 43 43 43 57 58 68 67 59 43 43 43 43 43 43 43 62 64 43 43 43 43 43 43 43 43 43 43 43 43 43 43 43 43 43 43 43 43 43 43 
43 43 43 43 43 43 43 43 43 43 43 43 43 57 68 65 63 63 64 43 43 43 43 43 43 43 43 43 43 43 43 43 43 43 43 43 43 43 43 43 43 43 43 43 43 43 43 43 43 43 
43 43 43 43 43 43 43 43 43 43 43 43 43 62 63 64 43 43 43 43 43 43 43 43 43 43 43 43 43 43 43 43 43 43 43 43 43 43 43 43 43 43 43 43 43 43 43 43 43 43 
