1 1 1 1 1 1 1 1 1 1 1 1 1 1 1 2 1 1 1 1 1 1 1 1 1 1 1 1 1 1 1 1 33 21 14 13 26 119 121 1 1 1 1 1 1 1 1 1 1 1 
1 1 1 1 1 1 2 1 4 1 1 1 1 1 122 1 1 1 1 4 1 1 1 1 1 1 2 122 1 1 118 120 33 21 14 13 26 1 2 1 1 122 1 1 2 1 1 2 1 1 
1 1 1 1 1 1 1 122 1 118 120 1 1 2 1 1 1 118 120 1 1 122 1 1 1 1 1 8 1 1 119 121 33 21 34 13 26 1 1 1 1 1 1 1 1 1 1 1 1 1 
1 1 8 1 1 1 1 1 1 119 121 118 120 1 1 8 1 119 121 1 4 1 118 120 1 4 1 1 1 1 4 1 33 21 14 13 26 1 4 118 120 1 1 1 1 8 1 1 1 1 
1 1 1 1 118 120 4 8 1 4 1 119 121 1 118 120 1 4 1 118 120 2 119 121 122 1 118 120 4 1 1 2 33 21 14 13 26 122 1 119 121 1 1 2 118 120 1 1 1 1 
1 2 1 4 119 121 1 118 120 2 1 1 122 1 119 121 1 1 122 119 121 1 4 1 1 8 119 121 1 1 122 1 33 21 14 13 26 1 1 1 4 1 122 1 119 121 1 1 122 1 
1 1 1 1 1 2 1 119 121 29 27 27 27 28 1 29 27 27 27 27 27 27 27 27 27 27 27 27 27 28 1 29 24 21 14 13 26 4 118 120 1 1 1 1 1 8 2 1 1 1 
1 1 1 1 1 118 120 1 29 24 1 1 1 25 27 24 46 44 44 44 44 44 44 44 44 44 44 44 45 25 27 24 1 21 14 13 25 28 119 121 1 1 118 120 4 1 1 1 1 8 
1 118 120 4 1 119 121 29 24 4 1 1 123 1 1 1 50 43 43 43 43 43 43 43 43 36 43 43 42 1 1 1 4 21 14 13 4 25 27 27 28 4 119 121 1 1 1 1 2 1 
1 119 121 1 122 1 29 24 4 128 134 129 4 4 1 1 50 43 43 43 43 43 37 43 43 43 81 52 53 1 1 4 4 21 34 13 4 4 1 1 25 28 8 4 1 1 1 1 4 1 
1 1 4 1 1 1 33 4 1 130 135 131 4 4 4 1 50 43 36 43 43 43 43 43 43 43 43 43 42 1 4 4 4 21 14 13 4 4 4 1 1 25 28 1 4 118 120 1 118 120 
1 1 1 1 118 120 33 126 1 132 136 133 4 4 4 4 49 47 47 47 47 47 47 47 47 47 47 47 48 4 4 4 4 21 14 13 4 4 4 4 1 1 25 28 122 119 121 1 119 121 
1 1 8 1 119 121 33 101 1 17 15 15 15 15 15 15 15 15 15 15 15 15 15 15 15 15 15 15 15 15 15 15 15 11 14 12 15 15 15 15 15 16 1 26 1 4 1 4 1 1 
122 1 1 2 1 1 33 102 1 21 35 14 14 14 14 14 34 14 14 14 14 14 35 14 14 14 14 14 14 34 14 14 14 14 35 14 14 14 14 14 35 13 1 26 1 2 1 8 1 1 
1 1 1 1 1 1 33 127 1 20 18 18 18 18 18 18 18 18 18 18 18 9 14 10 18 18 18 18 18 18 18 18 18 18 18 18 18 18 18 18 18 19 1 26 1 1 1 1 1 122 
2 1 118 120 1 1 33 4 4 46 44 44 44 44 44 44 44 45 4 4 1 21 14 13 4 4 4 4 4 4 4 4 4 4 1 4 4 4 4 4 4 4 4 26 1 4 118 120 1 1 
1 1 119 121 1 122 33 4 46 40 43 43 43 43 43 43 43 41 45 4 1 21 14 13 4 1 1 3 1 1 4 1 1 4 2 4 3 1 1 5 1 2 4 25 28 1 119 121 1 1 
1 1 1 1 1 1 33 4 50 43 43 36 43 43 37 43 43 43 41 45 1 21 14 13 4 75 4 4 4 4 4 74 4 4 1 4 1 4 4 4 4 1 4 4 26 1 1 1 1 2 
1 1 1 1 2 1 33 4 50 43 43 39 38 39 38 43 43 43 43 42 4 21 14 13 4 2 1 5 1 1 4 1 1 4 3 1 75 1 2 1 4 8 4 4 26 1 1 4 1 1 
1 1 1 1 1 29 24 46 40 43 106 41 40 42 49 38 106 43 43 42 4 21 34 13 4 1 4 4 4 4 4 4 1 5 1 4 4 4 1 1 4 4 4 4 26 122 1 1 118 120 
1 1 1 1 1 33 4 50 43 39 38 43 43 42 78 50 43 36 43 41 45 21 14 13 4 72 8 3 1 1 4 2 1 4 1 1 1 4 4 4 4 1 4 4 26 1 1 2 119 121 
1 1 122 118 120 33 4 50 43 41 40 43 39 48 77 49 38 43 43 43 42 21 14 13 4 4 4 4 4 1 4 1 4 4 4 3 1 1 3 4 75 1 4 4 26 1 1 8 1 1 
1 1 1 119 121 33 4 50 43 43 43 43 42 1 1 1 50 43 43 43 42 21 14 13 4 74 1 75 8 3 4 1 4 1 1 1 1 4 72 4 8 4 4 23 31 118 120 1 1 1 
1 1 4 1 1 32 22 49 38 43 43 37 42 1 1 1 51 52 52 52 53 21 35 13 4 1 5 1 4 1 1 1 4 8 4 4 4 4 1 4 4 4 23 31 1 119 121 1 73 1 
1 1 1 1 1 1 32 22 49 38 43 106 41 45 1 1 50 43 43 43 42 21 14 13 4 1 4 4 4 4 4 1 4 1 4 23 22 4 2 4 4 23 31 1 1 1 4 1 1 1 
1 8 1 4 1 1 1 32 22 50 43 43 43 42 4 46 40 43 43 43 42 21 14 13 4 3 4 23 30 22 4 4 4 4 4 25 24 4 5 4 4 26 1 1 8 2 1 1 2 1 
1 1 1 1 1 8 118 120 33 50 43 43 36 41 44 40 43 39 38 43 42 21 14 13 4 1 4 25 27 24 4 5 72 2 4 4 4 4 1 4 4 26 1 3 1 1 1 8 1 1 
1 1 1 1 1 1 119 121 33 49 38 43 43 43 43 43 106 41 40 39 48 21 14 13 4 1 4 4 4 4 4 75 1 1 1 1 3 1 74 4 4 26 1 1 1 72 1 1 4 118 
1 1 2 1 1 4 1 1 33 78 49 38 43 43 43 43 37 43 39 48 78 21 14 13 4 8 2 1 1 1 4 3 1 74 4 4 4 4 4 4 4 26 1 1 1 1 1 1 1 119 
1 8 1 118 120 1 1 3 33 77 4 49 47 47 47 47 47 47 48 4 77 21 34 13 4 1 4 4 4 4 4 4 4 4 4 23 30 30 30 22 4 26 8 118 120 4 1 1 1 1 
1 1 1 119 121 1 1 1 33 1 1 2 1 74 7 1 1 75 74 7 74 21 14 13 4 1 5 75 1 4 72 1 2 1 1 26 4 4 4 33 4 26 1 119 121 1 1 72 1 1 
1 1 1 1 1 1 72 1 33 1 3 1 75 1 1 74 1 1 2 1 3 21 14 13 4 3 1 4 2 1 74 4 4 4 4 25 27 27 27 24 4 26 1 1 79 1 1 1 1 1 
1 79 3 1 73 1 1 1 33 72 1 7 1 2 1 1 7 1 75 1 1 21 14 13 4 4 4 4 4 4 4 4 4 4 4 4 4 4 4 4 4 26 1 1 77 1 1 3 1 2 
1 77 1 1 1 79 1 2 33 1 79 1 74 1 75 3 1 72 1 79 7 21 14 13 1 79 72 1 1 1 1 1 79 1 1 2 1 72 6 79 1 26 2 1 1 1 1 1 79 1 
1 1 1 1 1 77 1 29 24 4 77 4 8 72 1 1 73 1 4 77 8 21 14 13 1 77 4 1 6 1 8 4 77 4 1 1 8 1 4 77 4 26 1 1 1 72 1 2 77 1 
2 1 72 1 2 1 29 24 29 27 27 27 27 27 27 27 27 27 28 4 22 21 35 13 23 4 1 1 1 72 1 1 3 1 6 29 27 27 27 27 28 25 28 8 1 1 1 1 1 1 
1 1 79 1 1 29 24 29 24 17 15 15 15 15 15 15 15 16 25 27 24 20 18 19 25 28 1 2 1 29 27 27 27 27 27 24 17 15 15 16 25 28 25 28 3 1 79 1 73 1 
8 1 77 1 29 24 29 24 17 11 138 14 14 34 14 14 14 12 15 15 15 15 15 15 16 25 27 27 27 24 17 15 15 15 15 15 11 14 14 12 16 25 28 25 28 1 77 1 1 1 
1 1 1 29 24 29 24 17 11 14 14 14 140 14 14 14 140 14 14 14 14 34 14 14 12 15 15 15 15 15 11 14 14 14 139 14 14 14 138 14 12 16 25 28 25 28 1 1 1 8 
27 27 27 24 29 24 17 11 14 139 14 14 14 14 137 14 14 14 14 139 14 14 14 14 14 14 138 14 14 140 14 14 34 14 14 35 140 14 14 34 14 12 16 25 28 25 27 27 27 27 
27 27 27 27 24 17 11 14 14 14 14 14 14 14 14 14 14 138 14 14 14 14 14 14 35 14 14 14 139 14 14 138 14 14 14 14 14 14 14 14 14 14 12 16 25 27 27 27 27 27 
15 15 15 15 15 11 65 63 63 63 63 63 66 14 14 34 14 14 14 65 63 63 63 63 63 63 66 14 14 14 14 14 14 14 65 63 63 63 63 63 63 66 14 12 15 15 15 15 15 15 
63 63 63 63 63 63 64 43 43 43 43 43 62 63 63 63 63 63 63 64 43 43 43 43 43 43 62 63 63 63 63 63 63 63 64 43 43 43 43 43 43 62 63 63 63 63 63 63 63 63 
43 43 43 43 43 43 43 43 36 43 43 43 43 43 43 43 43 43 36 43 43 43 43 37 43 43 43 43 43 43 43 43 43 43 36 43 57 59 43 43 37 43 43 43 43 43 43 43 43 36 
43 43 43 43 57 58 58 59 43 43 43 43 37 43 43 43 43 43 43 43 43 43 43 43 43 43 43 36 43 43 37 43 43 43 43 43 62 64 43 43 57 59 43 43 43 43 43 43 43 43 
43 43 43 43 60 14 14 61 43 43 43 43 43 43 43 43 43 43 43 37 43 43 43 43 57 58 58 59 43 43 43 43 43 43 43 43 43 43 57 59 62 64 43 43 43 36 43 43 43 43 
43 43 43 43 62 63 63 64 43 43 43 43 43 43 43 43 57 59 43 43 43 43 43 43 62 63 66 61 43 43 43 43 43 43 43 43 43 43 62 64 43 37 43 43 43 43 43 43 43 43 
43 43 43 43 43 43 43 43 43 43 43 43 43 43 57 58 68 67 59 43 43 43 43 43 43 43 62 64 43 43 43 36 43 43 43 43 43 43 43 43 43 43 43 43 43 43 43 43 37 43 
43 43 43 43 43 43 43 43 43 36 43 43 43 57 68 65 63 63 64 43 43 43 43 37 43 43 43 43 43 43 43 43 43 43 43 43 37 43 43 43 43 43 43 43 43 43 43 43 43 43 
43 43 43 43 43 43 43 43 43 43 43 43 43 62 63 64 43 43 43 43 43 43 43 43 43 43 43 43 43 43 43 43 43 43 43 43 43 43 43 43 43 43 43 36 43 43 43 43 43 43 
