43 43 43 43 43 43 43 43 43 43 43 43 43 43 43 43 43 43 43 43 43 43 43 43 43 43 43 43 43 43 43 43 43 43 43 43 43 43 43 43 43 43 43 43 43 43 43 43 43 43 
43 43 43 43 43 43 43 43 43 43 43 43 43 43 43 43 43 43 43 43 43 43 43 43 43 43 43 43 43 43 43 43 43 43 43 43 43 43 43 43 43 43 43 43 43 43 43 43 43 43 
43 43 43 43 43 43 43 43 43 43 43 43 43 43 43 43 43 43 43 43 43 43 43 43 43 43 43 43 43 43 43 43 43 43 43 43 43 43 43 43 43 43 43 43 43 43 43 43 43 43 
43 43 43 43 43 43 43 43 43 43 43 43 43 43 43 43 43 43 43 43 43 43 43 43 43 43 43 43 43 43 43 43 43 43 43 43 43 43 43 43 43 43 43 43 43 43 43 43 43 43 
43 43 43 43 43 43 43 43 43 43 43 43 43 43 43 43 43 43 43 43 43 43 43 43 43 43 43 43 43 43 43 43 43 43 43 43 43 43 43 43 43 43 43 43 43 43 43 43 43 43 
43 43 43 43 43 43 43 43 43 43 43 43 43 43 43 43 43 43 43 43 43 43 43 43 43 43 43 43 43 43 43 43 43 43 43 43 43 43 43 43 43 43 43 43 43 43 43 43 43 43 
43 43 43 43 43 43 43 43 43 43 43 43 43 43 43 43 43 43 43 43 43 43 43 43 43 43 43 43 43 43 43 43 43 43 43 43 43 43 43 43 43 43 43 43 43 43 43 43 43 43 
43 43 43 43 43 43 39 47 38 43 43 43 43 43 43 43 43 43 43 43 43 43 43 43 43 43 43 43 43 39 47 47 47 47 47 47 47 47 47 47 38 43 43 43 43 43 43 43 43 43 
43 43 43 43 43 43 42 4 49 47 38 43 43 43 43 39 47 47 47 47 38 43 43 43 43 43 43 43 39 48 23 30 30 30 30 30 30 30 30 22 49 38 43 43 43 43 43 43 43 43 
43 43 43 43 43 43 42 4 4 1 49 47 47 47 47 48 6 1 4 1 49 38 43 43 43 43 43 43 42 23 31 23 30 30 30 30 30 30 22 32 22 50 43 43 43 43 43 43 43 43 
43 43 43 43 43 43 42 4 4 4 1 1 1 1 1 17 15 16 4 4 1 49 38 43 43 43 43 43 42 26 4 26 5 1 1 4 4 4 33 4 33 50 43 43 43 43 43 43 43 43 
43 43 43 43 43 43 41 28 1 1 1 1 1 8 1 21 34 13 4 4 4 1 50 43 43 43 43 43 42 26 4 25 24 1 25 27 27 27 24 29 24 50 43 43 43 43 43 43 43 43 
43 43 43 43 43 43 43 41 28 1 1 3 1 1 4 21 14 13 4 4 4 4 50 43 43 43 43 43 42 25 28 8 2 1 1 1 1 3 1 33 46 40 43 43 43 43 43 43 43 43 
43 43 43 43 43 43 43 43 42 1 5 1 1 4 4 21 14 12 15 15 15 16 49 38 43 43 43 43 41 45 25 27 27 27 24 1 25 27 27 24 50 43 43 43 43 43 43 43 43 43 
43 43 43 43 43 43 43 39 48 1 1 1 4 4 4 21 35 14 14 34 14 13 8 50 43 43 43 43 43 41 45 6 4 3 17 15 16 1 1 1 50 43 43 43 43 43 43 43 43 43 
43 43 43 43 43 43 43 42 1 1 1 4 4 4 4 21 14 10 18 18 18 19 3 50 43 43 43 43 43 43 41 45 2 8 21 14 12 15 15 16 49 38 43 43 43 43 43 43 43 43 
43 43 43 43 43 43 43 42 2 17 15 15 15 15 15 11 14 13 4 4 4 4 4 49 38 43 43 43 43 43 43 41 44 45 21 14 14 14 14 13 1 50 43 43 43 43 43 43 43 43 
43 43 43 43 43 43 43 42 7 21 34 14 14 35 14 14 14 13 4 4 4 4 4 4 49 47 47 38 43 43 43 43 43 42 21 14 10 18 18 19 1 50 43 43 43 43 43 43 43 43 
43 43 43 43 43 43 43 42 8 20 18 18 18 18 18 9 14 12 15 15 15 15 15 15 15 16 4 50 43 43 43 43 43 42 21 14 13 1 1 1 46 40 43 43 43 43 43 43 43 43 
43 43 43 43 43 43 43 41 44 45 4 4 4 4 5 21 14 14 14 14 14 34 14 14 35 13 2 51 52 52 52 52 52 53 21 14 13 1 1 1 50 43 43 43 43 43 43 43 43 43 
43 43 43 43 43 43 43 43 43 42 4 4 4 17 15 11 14 10 18 18 18 18 18 18 18 19 4 50 43 43 43 43 43 42 21 14 13 1 1 1 50 43 43 43 43 43 43 43 43 43 
43 43 43 43 43 43 43 43 43 42 4 4 3 21 34 14 14 13 8 5 3 1 4 4 4 4 46 40 43 43 43 43 39 48 21 14 12 16 1 1 49 38 43 43 43 43 43 43 43 43 
43 43 43 43 43 43 43 43 39 48 4 8 1 21 14 10 18 19 2 1 8 7 4 4 4 46 40 43 43 43 43 39 48 1 20 9 14 13 1 1 1 50 43 43 43 43 43 43 43 43 
43 43 43 43 43 43 43 43 42 1 17 15 15 11 35 12 15 15 15 15 15 16 4 4 46 40 43 43 43 43 43 42 1 1 1 21 14 13 1 1 46 40 43 43 43 43 43 43 43 43 
43 43 43 43 43 43 43 43 41 45 21 14 14 14 14 14 14 14 34 14 35 13 4 46 40 43 43 43 43 43 43 42 1 1 1 21 14 13 1 46 40 43 43 43 43 43 43 43 43 43 
43 43 43 43 43 43 43 43 43 42 20 18 18 18 18 18 18 9 14 10 18 19 46 40 43 43 43 43 43 43 39 48 1 17 15 11 14 13 1 50 43 43 43 43 43 43 43 43 43 43 
43 43 43 43 43 43 43 43 43 41 45 4 4 3 4 4 4 21 35 13 6 8 50 43 43 43 43 43 39 47 48 1 1 21 14 14 14 13 1 50 43 43 43 43 43 43 43 43 43 43 
43 43 43 43 43 43 43 43 43 43 41 44 45 1 46 44 45 20 18 19 46 44 40 43 43 43 43 43 42 1 1 1 17 11 14 10 18 19 1 50 43 43 43 43 43 43 43 43 43 43 
43 43 43 43 43 43 43 43 43 43 43 43 41 44 40 43 41 45 1 46 40 43 43 43 43 43 43 43 42 1 1 1 21 14 10 19 1 1 1 50 43 43 43 43 43 43 43 43 43 43 
43 43 43 43 43 43 43 43 43 43 43 43 43 43 43 43 43 41 44 40 43 43 43 43 43 43 43 39 48 1 1 1 21 14 13 1 1 1 1 50 43 43 43 43 43 43 43 43 43 43 
43 43 43 43 43 43 43 43 43 43 43 43 43 43 43 43 43 43 43 43 43 43 43 43 43 43 39 48 1 1 1 1 20 18 19 1 1 1 1 50 43 43 43 43 43 43 43 43 43 43 
43 43 43 43 43 43 43 43 43 43 43 43 43 39 47 47 38 43 43 43 43 43 43 43 43 39 48 1 1 1 1 1 46 54 45 1 46 45 1 49 38 43 43 43 43 43 43 43 43 43 
43 43 43 43 43 43 43 39 47 47 38 43 39 48 1 1 50 43 39 47 38 43 39 47 47 48 1 1 1 1 46 44 40 55 41 44 40 41 45 1 49 38 43 43 43 43 43 43 43 43 
43 43 43 43 43 43 43 42 1 1 49 47 48 1 1 1 49 47 48 1 49 47 48 1 1 1 1 46 44 44 40 43 43 55 43 43 43 43 41 45 4 50 43 43 43 43 43 43 43 43 
43 43 43 43 43 43 43 42 1 1 1 1 1 1 1 1 1 1 1 1 1 1 1 1 1 1 46 40 43 43 43 43 43 55 43 43 43 43 43 42 4 50 43 43 43 43 43 43 43 43 
43 43 43 43 43 43 43 41 45 1 1 1 1 1 1 1 1 1 1 1 1 1 1 1 1 1 50 43 43 43 43 39 47 56 47 38 43 43 43 42 4 50 43 43 43 43 43 43 43 43 
43 43 43 43 43 43 43 43 41 45 1 1 1 1 1 1 1 1 1 1 1 1 1 1 1 1 50 43 43 43 43 42 1 1 1 50 43 43 43 42 4 49 38 43 43 43 43 43 43 43 
43 43 43 43 43 43 43 43 43 42 1 1 1 1 1 1 1 1 1 1 1 1 1 1 1 1 49 38 43 43 43 41 44 44 44 40 43 43 43 42 4 4 50 43 43 43 43 43 43 43 
43 43 43 43 43 43 43 43 39 48 1 1 1 1 1 1 1 1 1 1 1 1 1 1 1 1 1 49 38 43 43 43 43 43 43 43 43 43 43 42 4 46 40 43 43 43 43 43 43 43 
43 43 43 43 43 43 43 43 42 1 1 1 1 1 1 1 1 1 1 1 1 1 1 1 1 1 1 1 49 38 43 43 43 43 43 43 43 43 39 48 4 50 43 43 43 43 43 43 43 43 
43 43 43 43 43 43 43 43 42 1 1 1 1 1 1 1 1 1 1 1 1 1 1 1 1 1 1 1 1 49 47 47 47 47 47 47 47 47 48 4 46 40 43 43 43 43 43 43 43 43 
43 43 43 43 43 43 43 43 41 45 1 1 46 44 45 1 1 1 1 1 1 1 1 46 44 44 45 4 4 4 46 44 44 45 4 4 4 4 4 46 40 43 43 43 43 43 43 43 43 43 
43 43 43 43 43 43 43 43 43 41 44 44 40 43 41 44 44 45 4 4 4 4 4 50 43 43 41 44 44 44 40 43 43 41 44 44 44 44 44 40 43 43 43 43 43 43 43 43 43 43 
43 43 43 43 43 43 43 43 43 43 43 43 43 43 43 43 43 41 44 44 44 44 44 40 43 43 43 43 43 43 43 43 43 43 43 43 43 43 43 43 43 43 43 43 43 43 43 43 43 43 
43 43 43 43 43 43 43 43 43 43 43 43 43 43 43 43 43 43 43 43 43 43 43 43 43 43 43 43 43 43 43 43 43 43 43 43 43 43 43 43 43 43 43 43 43 43 43 43 43 43 
43 43 43 43 43 43 43 43 43 43 43 43 43 43 43 43 43 43 43 43 43 43 43 43 43 43 43 43 43 43 43 43 43 43 43 43 43 43 43 43 43 43 43 43 43 43 43 43 43 43 
43 43 43 43 43 43 43 43 43 43 43 43 43 43 43 43 43 43 43 43 43 43 43 43 43 43 43 43 43 43 43 43 43 43 43 43 43 43 43 43 43 43 43 43 43 43 43 43 43 43 
43 43 43 43 43 43 43 43 43 43 43 43 43 43 43 43 43 43 43 43 43 43 43 43 43 43 43 43 43 43 43 43 43 43 43 43 43 43 43 43 43 43 43 43 43 43 43 43 43 43 
43 43 43 43 43 43 43 43 43 43 43 43 43 43 43 43 43 43 43 43 43 43 43 43 43 43 43 43 43 43 43 43 43 43 43 43 43 43 43 43 43 43 43 43 43 43 43 43 43 43 
43 43 43 43 43 43 43 43 43 43 43 43 43 43 43 43 43 43 43 43 43 43 43 43 43 43 43 43 43 43 43 43 43 43 43 43 43 43 43 43 43 43 43 43 43 43 43 43 43 43 
