0 0 0 0 0 0 19 1 20 0 0 0 0 0 0 7
0 0 0 0 0 3 19 1 20 0 0 0 0 0 0 7
17 17 17 17 17 17 27 1 26 17 17 17 17 17 18 7
1 1 1 1 1 1 1 1 1 1 1 1 1 1 20 7
22 22 22 22 22 22 25 1 24 22 22 22 22 22 23 7
0 41 3 42 3 40 19 1 20 36 34 34 34 34 37 7
0 0 40 0 0 0 19 1 20 32 44 37 36 0 31 7
0 0 0 43 0 41 19 1 20 38 29 39 38 29 39 7
40 0 0 0 0 0 19 1 20 0 0 0 4 5 5 15
5 5 5 5 5 6 19 1 20 0 0 0 7 2 2 2
2 2 2 2 2 14 6 1 0 0 0 0 7 2 2 2
2 2 2 2 2 2 14 5 5 5 5 5 15 2 2 2 