118 120 1 77 1 1 1 3 1 4 1 1 1 1 1 3 1 1 1 73 1 1 1 1 1 77 1 1 1 1 1 1 73 1 1 1 1 122 1 1 77 1 1 79 1 1 122 1 1 119 
119 121 1 1 8 4 1 1 122 1 118 120 1 79 1 2 1 1 1 1 3 1 1 122 1 1 1 1 118 120 1 122 1 77 1 1 4 1 1 8 1 1 1 77 1 1 1 1 1 122 
1 4 1 1 1 2 1 79 1 1 119 121 1 77 1 122 1 1 122 1 4 118 120 1 8 73 1 8 119 121 4 1 2 1 8 1 118 120 1 1 4 118 120 122 1 1 4 1 1 8 
122 1 3 1 1 1 1 77 1 1 1 79 1 1 8 1 1 1 79 8 1 119 121 4 1 72 1 1 4 1 1 4 1 78 1 72 119 121 4 1 1 119 121 1 72 3 118 120 4 1 
79 1 1 118 120 1 1 1 2 1 4 77 3 1 4 1 1 1 77 1 1 4 1 1 3 118 120 2 1 122 118 120 8 77 3 1 122 1 1 118 120 1 4 1 4 73 119 121 1 79 
77 4 1 119 121 4 1 1 1 1 1 1 1 1 1 118 120 4 1 1 1 1 78 4 1 119 121 1 1 4 119 121 4 1 4 118 120 1 4 119 121 1 2 118 120 8 1 4 1 77 
1 1 8 1 1 1 1 29 27 27 27 27 27 28 1 119 121 1 1 4 1 8 77 118 120 122 1 118 120 29 27 27 27 27 28 119 121 29 27 27 27 27 28 119 121 1 122 1 8 1 
2 1 78 1 3 1 29 24 122 1 2 1 1 25 27 28 1 3 1 73 3 4 1 119 121 1 4 119 121 33 111 114 112 78 25 27 27 24 79 4 4 4 25 28 1 1 4 1 1 1 
73 1 77 1 1 4 33 79 46 44 44 44 45 1 4 25 27 27 27 28 122 1 1 1 1 118 120 1 8 33 116 115 117 77 4 4 4 4 77 75 1 73 78 26 118 120 1 1 1 73 
2 79 122 1 3 8 33 80 50 36 43 43 41 44 44 44 45 78 1 25 27 27 28 122 4 119 121 72 1 33 109 113 110 4 1 1 75 1 123 1 7 3 77 26 119 121 3 122 2 118 
1 77 4 118 120 1 33 77 50 43 43 43 43 43 43 43 42 77 1 1 4 73 26 1 1 1 79 1 29 24 17 15 16 123 74 78 4 4 4 123 2 74 4 26 8 118 120 8 1 119 
122 1 1 119 121 1 32 22 50 43 106 106 106 106 106 43 42 1 78 1 1 1 25 27 27 28 77 4 33 4 21 34 13 4 4 77 78 72 1 75 78 4 23 31 2 119 121 1 4 1 
78 1 3 1 2 1 1 33 50 43 37 43 43 43 36 43 42 1 77 1 1 1 1 1 78 26 4 1 33 4 21 14 12 15 16 78 77 1 6 1 77 1 26 118 120 122 72 118 120 8 
77 1 1 79 1 118 120 33 50 43 43 43 81 52 52 52 53 1 1 1 72 1 1 79 77 26 1 1 33 4 21 14 14 14 13 77 78 74 2 75 78 23 31 119 121 3 1 119 121 4 
4 8 4 77 1 119 121 33 50 43 43 36 43 43 43 43 42 3 1 71 1 1 1 77 1 26 1 79 32 22 20 18 9 14 13 4 77 4 123 4 77 26 118 120 4 1 8 2 122 1 
1 118 120 1 122 1 1 33 50 43 43 43 43 43 43 43 42 8 1 1 1 1 1 4 8 25 28 77 122 33 4 74 21 14 13 78 8 1 1 78 4 26 119 121 2 1 118 120 1 118 
72 119 121 1 2 1 29 24 49 47 47 47 38 43 43 36 42 1 2 74 1 1 1 1 1 4 26 3 73 33 4 8 21 34 13 80 1 5 74 77 23 31 79 8 122 73 119 121 3 119 
4 122 78 1 1 2 33 78 5 74 1 1 49 47 47 47 48 75 1 1 1 1 1 1 1 1 26 8 78 33 4 1 21 14 13 80 75 75 72 4 26 4 77 73 1 122 8 1 2 78 
8 1 77 118 120 1 33 77 79 1 2 75 5 3 1 74 8 1 1 8 1 1 78 1 75 1 26 4 77 33 6 75 21 14 13 77 78 4 4 4 25 27 28 1 118 120 4 1 1 77 
118 120 2 119 121 4 33 4 77 78 8 79 74 79 2 79 5 79 74 79 1 79 77 17 15 16 26 118 120 33 72 1 21 14 13 4 77 46 44 44 44 45 26 79 119 121 1 1 1 118 
119 121 4 1 1 1 32 30 22 77 4 77 4 77 4 77 4 77 4 77 4 77 4 21 14 13 26 119 121 32 30 22 21 14 13 46 44 40 43 43 43 42 26 77 122 3 72 1 4 119 
1 1 118 120 122 118 120 8 32 30 30 30 30 30 30 30 30 30 30 30 30 30 22 21 34 13 26 79 118 120 78 33 21 14 13 50 43 43 43 43 43 42 26 8 1 4 118 120 1 73 
3 8 119 121 3 119 121 1 122 2 72 4 122 78 8 118 120 3 4 2 79 4 33 21 14 13 26 77 119 121 77 33 21 14 13 50 43 43 43 43 43 42 26 118 120 1 119 121 122 8 
122 1 1 78 1 1 1 118 120 1 4 3 4 77 4 119 121 122 4 8 77 29 24 21 14 13 26 78 122 118 120 33 21 35 13 50 43 43 43 43 43 42 26 119 121 2 29 27 27 27 
1 118 120 77 4 1 2 119 121 29 27 27 27 27 27 27 27 27 27 27 27 24 6 21 14 13 26 77 8 119 121 33 21 14 13 49 47 47 47 47 47 48 25 27 27 27 24 4 4 4 
2 119 121 1 1 122 1 1 29 24 17 15 15 15 15 15 15 15 15 15 15 15 15 11 14 13 26 118 120 29 27 24 21 14 12 15 15 15 15 15 15 15 15 15 15 15 15 15 15 15 
1 1 8 79 1 118 120 29 24 78 21 35 14 14 14 14 14 34 14 14 14 14 14 14 35 13 26 119 121 33 1 1 21 14 14 14 14 14 14 14 14 14 14 34 14 14 14 14 14 14 
73 1 1 77 2 119 121 33 1 77 21 14 10 18 18 18 18 18 18 18 18 18 18 18 18 19 26 72 122 33 1 78 21 14 10 18 18 18 18 18 18 18 18 18 18 18 18 18 18 18 
4 118 120 1 1 79 1 32 22 4 21 14 13 4 4 4 74 1 4 4 4 1 73 4 4 4 26 1 78 33 1 77 21 34 13 78 4 74 4 78 4 78 23 30 30 30 22 4 4 4 
2 119 121 3 1 77 122 72 33 2 21 34 13 4 46 44 44 44 44 44 44 44 44 44 45 4 26 2 77 33 1 75 21 14 13 77 8 2 4 77 4 80 26 118 120 4 32 30 30 30 
122 1 79 1 1 1 1 8 33 79 21 14 13 78 50 43 43 43 43 43 43 43 43 43 42 78 26 122 72 33 4 73 21 14 13 4 4 1 75 1 73 77 26 119 121 1 118 120 8 122 
1 1 77 122 1 1 4 1 33 80 21 14 13 80 50 43 36 43 39 47 38 43 37 43 42 80 26 8 3 33 1 1 21 14 12 15 16 4 78 4 3 4 26 122 1 3 119 121 1 4 
1 8 2 1 118 120 1 3 33 80 21 14 13 80 50 43 43 43 42 5 50 43 43 43 42 80 26 4 79 33 74 1 21 35 14 14 13 78 77 1 1 8 25 28 118 120 122 1 73 118 
1 4 118 120 119 121 1 29 24 77 21 14 13 77 50 43 43 37 41 54 40 43 43 43 42 77 26 73 77 33 1 4 20 18 9 14 13 77 4 2 4 78 78 26 119 121 4 1 2 119 
79 1 119 121 72 1 2 33 3 74 21 35 13 4 50 43 43 43 43 55 43 43 43 36 42 4 26 118 120 33 79 1 74 4 21 14 13 78 79 8 74 77 77 26 72 1 1 118 120 4 
77 1 3 1 4 1 29 24 78 1 21 14 13 4 49 47 47 47 47 56 47 47 47 47 48 4 26 119 121 33 77 75 4 4 21 14 13 80 77 78 1 3 23 31 1 122 8 119 121 1 
1 8 1 1 118 120 33 74 77 1 21 14 13 4 4 4 72 4 1 3 1 4 75 4 4 4 25 27 27 24 8 4 4 4 21 14 13 80 78 77 4 72 26 118 120 2 1 3 1 1 
2 4 1 1 119 121 33 73 1 2 21 34 12 15 15 15 15 15 15 15 15 15 15 15 15 15 15 15 15 15 15 15 15 15 11 14 13 80 77 73 2 1 26 119 121 1 1 1 4 8 
1 1 1 1 1 1 32 22 1 74 21 14 14 14 14 14 14 14 35 14 14 14 14 14 14 34 14 14 14 14 35 14 14 14 14 34 13 77 4 1 78 79 26 1 4 1 73 1 1 118 
1 1 1 72 1 118 120 33 75 79 20 18 18 18 18 18 18 18 18 18 18 18 18 18 18 18 18 18 18 18 18 18 18 18 18 18 19 78 4 75 77 77 25 28 1 118 120 1 122 119 
8 1 1 4 1 119 121 32 22 77 4 1 78 75 74 2 1 4 75 1 2 23 30 30 30 30 30 30 30 22 4 4 4 78 4 78 4 80 7 3 75 4 4 26 8 119 121 4 1 2 
122 118 120 1 1 2 1 73 32 22 3 1 77 72 73 1 23 30 30 30 30 31 2 1 1 118 120 122 1 32 30 30 22 77 4 77 4 77 74 1 7 4 23 31 78 118 120 73 1 1 
2 119 121 1 118 120 4 118 120 32 22 74 75 23 30 30 31 118 120 73 8 122 1 4 1 119 121 1 2 118 120 73 32 30 30 30 30 30 22 7 74 23 31 8 77 119 121 4 1 2 
1 1 1 1 119 121 1 119 121 3 32 30 30 31 1 8 1 119 121 1 1 118 120 1 79 1 3 4 1 119 121 8 73 118 120 4 1 72 32 30 30 31 118 120 4 2 122 1 1 1 
1 8 1 78 3 1 1 122 72 1 4 118 120 1 122 2 3 1 122 4 1 119 121 1 77 72 1 1 122 1 1 4 2 119 121 122 118 120 122 1 4 3 119 121 1 72 1 3 1 4 
1 1 122 77 1 1 1 1 1 118 120 119 121 1 1 1 1 1 2 1 1 1 122 1 1 79 1 118 120 1 1 1 1 79 1 8 119 121 4 118 120 79 8 1 4 1 118 120 122 1 
1 1 1 1 118 120 2 1 8 119 121 1 1 1 72 1 8 118 120 1 72 3 1 1 4 77 1 119 121 1 2 79 122 77 118 120 2 1 73 119 121 77 4 122 3 1 119 121 2 79 
1 118 120 73 119 121 1 1 1 1 1 122 3 1 1 1 79 119 121 1 1 1 1 2 1 1 1 4 1 122 1 77 3 1 119 121 1 78 118 120 1 1 1 118 120 122 4 78 1 77 
1 119 121 1 1 1 4 1 118 120 78 1 1 8 1 1 77 122 1 4 73 1 78 1 1 1 8 1 1 3 1 122 1 4 72 1 122 77 119 121 1 2 79 119 121 1 2 77 1 1 
72 1 122 1 2 1 73 1 119 121 77 1 1 1 122 73 1 1 1 1 1 1 77 4 1 1 4 1 1 4 1 1 8 1 2 1 1 4 1 122 8 1 77 1 1 73 1 8 1 4 
