1 1 1 1 1 1 1 1 1 1 1 1 1 1 1 1 1 1 1 1 1 1 1 1 1 1 1 1 1 1 1 1 1 1 1 1 1 1 1 1 1 1 1 1 1 1 1 1 1 1 
1 1 1 1 1 1 1 1 1 1 1 1 1 1 1 1 1 1 1 1 1 1 1 1 1 1 1 1 1 1 1 1 1 1 1 1 1 1 1 1 1 1 1 1 1 1 1 1 1 1 
1 1 1 1 1 1 1 1 1 1 1 1 1 1 1 1 1 1 1 1 1 1 1 1 1 1 1 1 1 1 1 1 1 1 1 1 1 1 1 1 1 1 1 1 1 1 1 1 1 1 
1 1 1 1 1 1 1 1 1 1 1 1 1 1 1 1 1 1 1 1 1 1 1 1 1 1 1 1 1 1 1 1 1 1 1 1 1 1 1 1 1 1 1 1 1 1 1 1 1 1 
1 1 1 1 1 1 1 1 1 1 1 1 1 1 1 1 1 1 1 1 1 1 1 1 3 1 1 3 1 1 1 1 1 1 1 1 1 1 1 1 1 1 1 1 1 1 1 1 1 1 
1 1 1 1 1 1 1 1 1 1 1 1 1 1 1 1 4 1 1 1 1 1 1 1 1 1 1 1 1 1 1 1 1 1 1 1 1 1 1 1 1 1 1 1 1 1 1 1 1 1 
1 1 1 1 1 1 1 29 27 27 27 27 27 28 1 1 1 1 1 4 1 1 1 1 1 1 1 1 1 29 27 27 27 27 28 1 1 29 27 27 27 27 28 1 1 1 1 1 1 1 
1 1 1 1 1 1 29 24 1 1 1 1 1 25 27 28 1 3 1 1 3 4 1 1 1 1 1 1 1 33 111 114 112 78 25 27 27 24 78 4 4 4 25 28 1 1 1 1 1 1 
1 1 1 1 1 1 33 79 46 44 44 44 45 1 4 25 27 27 27 28 1 1 1 1 1 1 1 1 1 33 116 115 117 77 6 1 1 75 77 75 1 73 78 26 1 1 1 1 1 1 
1 1 1 1 1 1 33 80 50 36 43 43 41 44 44 44 45 78 1 25 27 27 28 1 1 1 1 1 1 33 109 113 110 4 1 1 1 1 72 1 5 3 77 26 1 1 1 1 1 1 
1 1 1 1 1 1 33 77 50 43 43 43 43 43 43 43 42 77 1 1 4 73 26 1 1 1 79 1 29 24 17 15 16 1 74 1 2 1 78 8 2 74 4 26 1 1 1 1 1 1 
1 1 1 1 1 1 32 22 50 43 106 106 106 106 106 43 42 1 78 1 1 1 25 27 27 28 77 4 33 4 21 34 13 75 1 8 1 1 77 4 4 4 23 31 1 1 1 1 1 1 
1 1 1 1 1 1 1 33 50 43 37 43 43 43 36 43 42 1 77 1 1 1 1 1 78 26 4 1 33 4 21 14 12 15 15 15 15 16 1 1 1 1 26 1 1 1 1 1 1 1 
1 1 1 1 1 1 1 33 50 43 43 43 81 52 52 52 53 1 1 1 72 1 1 79 77 26 1 1 33 4 21 14 14 14 14 14 35 13 2 1 74 23 31 1 1 1 1 1 1 1 
1 1 1 1 1 1 1 33 50 43 43 36 43 43 43 43 42 1 1 71 1 1 1 77 1 26 1 79 32 22 20 18 9 14 10 18 18 19 1 6 1 26 1 1 1 1 1 1 1 1 
1 1 1 1 1 1 1 33 50 43 106 106 106 106 106 43 42 4 1 1 1 1 1 4 8 25 28 77 1 33 4 74 21 14 13 79 4 1 73 1 1 26 1 1 1 1 1 1 1 1 
1 1 1 1 1 1 29 24 49 47 47 47 38 43 43 36 42 4 4 74 1 1 1 1 1 4 26 1 1 33 4 8 21 34 13 77 78 1 1 1 1 25 27 28 1 1 1 1 1 1 
1 1 1 1 1 1 33 4 4 4 4 4 49 47 47 47 48 4 4 4 1 1 1 1 1 1 26 1 78 33 4 1 21 14 13 75 77 46 44 44 44 27 45 26 1 1 1 1 1 1 
1 1 1 1 1 1 33 4 4 4 4 4 4 4 4 4 4 4 4 4 4 1 1 1 75 1 26 4 77 33 6 75 21 14 13 78 74 50 43 43 43 43 42 26 1 1 1 1 1 1 
1 1 1 1 1 1 33 4 4 4 4 4 4 4 4 4 4 4 4 4 4 4 1 17 15 16 26 118 120 33 72 1 21 14 13 77 4 50 43 43 43 43 42 26 1 1 1 1 1 1 
1 1 1 1 1 1 32 30 22 4 4 4 4 4 4 4 4 4 4 4 4 4 4 21 14 13 26 119 121 32 30 22 21 14 13 1 1 49 47 38 43 43 42 26 1 1 1 1 1 1 
1 1 1 1 1 1 1 1 32 30 30 30 30 30 30 30 30 30 30 30 30 30 22 21 34 13 26 79 118 120 78 33 21 14 13 23 30 30 22 50 43 43 42 26 1 1 1 1 1 1 
1 1 1 1 1 1 1 1 75 2 72 4 5 78 8 4 73 3 4 2 79 4 33 21 14 13 26 77 119 121 77 33 21 14 13 26 118 120 33 50 43 43 42 26 1 1 1 1 1 1 
1 1 1 1 1 1 1 1 1 1 4 3 4 77 4 74 4 5 4 8 77 29 24 21 14 13 26 78 1 118 120 33 21 35 13 26 119 121 33 50 43 43 42 26 1 1 29 27 27 27 
1 1 1 1 1 1 1 1 2 29 27 27 27 27 27 27 27 27 27 27 27 24 6 21 14 13 26 77 1 119 121 33 21 14 13 25 27 27 24 49 47 47 48 25 27 27 24 4 4 4 
1 1 1 1 1 1 1 1 29 24 17 15 15 15 15 15 15 15 15 15 15 15 15 11 14 13 26 118 120 29 27 24 21 14 12 15 15 15 15 15 15 15 15 15 15 15 15 15 15 15 
1 1 1 1 1 1 1 29 24 78 21 35 14 14 14 14 14 34 14 14 14 14 14 14 35 13 26 119 121 33 1 1 21 14 14 14 14 14 14 14 14 14 14 34 14 14 14 14 14 14 
1 1 1 1 1 1 1 33 1 77 21 14 10 18 18 18 18 18 18 18 18 18 18 18 18 19 26 1 1 33 1 78 21 14 10 18 18 18 18 18 18 18 18 18 18 18 18 18 18 18 
1 1 1 1 1 1 1 32 22 4 21 14 13 4 4 4 74 1 4 4 4 1 73 4 4 4 26 1 78 33 1 77 21 34 13 78 4 74 4 78 4 23 30 30 30 30 22 4 4 4 
1 1 1 1 1 1 1 1 33 2 21 34 13 4 46 44 44 44 44 44 44 44 44 44 45 4 26 1 77 33 1 75 21 14 13 77 8 2 4 77 4 26 1 1 1 1 32 30 30 30 
1 1 1 1 1 1 1 1 33 79 21 14 13 78 50 43 43 43 43 43 43 43 43 43 42 78 26 1 1 33 4 73 21 14 13 4 4 1 75 1 73 26 1 1 1 1 1 1 1 1 
1 1 1 1 1 1 1 1 33 80 21 14 13 80 50 43 36 43 39 47 38 43 37 43 42 80 26 1 1 33 1 1 21 14 12 15 16 4 78 4 3 25 28 1 1 1 1 1 1 1 
1 1 1 1 1 1 1 1 33 80 21 14 13 80 50 43 43 43 42 5 50 43 43 43 42 80 26 4 79 33 74 1 21 35 14 14 13 78 77 1 1 8 25 28 1 1 1 1 1 1 
1 1 1 1 1 1 1 29 24 77 21 14 13 77 50 43 43 37 41 54 40 43 43 43 42 77 26 1 77 33 1 4 20 18 9 14 13 77 4 2 4 78 78 26 1 1 1 1 1 1 
1 1 1 1 1 1 1 33 3 74 21 35 13 4 50 43 43 43 43 55 43 43 43 36 42 4 26 118 120 33 79 1 74 4 21 14 13 78 79 8 74 77 77 26 1 1 1 1 1 1 
1 1 1 1 1 1 29 24 78 1 21 14 13 4 49 47 47 47 47 56 47 47 47 47 48 4 26 119 121 33 77 75 4 4 21 14 13 80 77 78 1 3 23 31 1 1 1 1 1 1 
1 1 1 1 1 1 33 74 77 1 21 14 13 4 4 4 72 4 1 3 1 4 75 4 4 4 25 27 27 24 8 4 4 4 21 14 13 80 78 77 4 72 26 1 1 1 1 1 1 1 
1 1 1 1 1 1 33 73 1 2 21 34 12 15 15 15 15 15 15 15 15 15 15 15 15 15 15 15 15 15 15 15 15 15 11 14 13 80 77 73 2 1 26 1 1 1 1 1 1 1 
1 1 1 1 1 1 32 22 1 74 21 14 14 14 14 14 14 14 35 14 14 14 14 14 14 34 14 14 14 14 35 14 14 14 14 34 13 77 4 1 78 79 26 1 1 1 1 1 1 1 
1 1 1 1 1 1 1 33 75 79 20 18 18 18 18 18 18 18 18 18 18 18 18 18 18 18 18 18 18 18 18 18 18 18 18 18 19 78 4 75 77 77 25 28 1 1 1 1 1 1 
1 1 1 1 1 1 1 32 22 77 4 1 78 75 74 2 1 4 75 1 2 23 30 30 30 30 30 30 30 22 4 4 4 78 4 78 4 80 7 3 75 4 4 26 1 1 1 1 1 1 
1 1 1 1 1 1 1 1 32 22 3 1 77 72 73 1 23 30 30 30 30 31 1 1 1 1 1 1 1 32 30 30 22 77 4 77 4 77 74 1 7 4 23 31 1 1 1 1 1 1 
1 1 1 1 1 1 1 1 1 32 22 74 75 23 30 30 31 1 1 1 1 1 1 1 1 1 1 1 1 1 1 1 32 30 30 30 30 30 22 7 74 23 31 1 1 1 1 1 1 1 
1 1 1 1 1 1 1 1 1 1 32 30 30 31 1 1 1 1 1 1 1 1 1 1 1 1 1 1 1 1 1 1 1 1 1 1 1 1 32 30 30 31 1 1 1 1 1 1 1 1 
1 1 1 1 1 1 1 1 1 1 1 1 1 1 1 1 1 1 1 1 1 1 1 1 1 1 1 1 1 1 1 1 1 1 1 1 1 1 1 1 1 1 1 1 1 1 1 1 1 1 
1 1 1 1 1 1 1 1 1 1 1 1 1 1 1 1 1 1 1 1 1 1 1 1 1 1 1 1 1 1 1 1 1 1 1 1 1 1 1 1 1 1 1 1 1 1 1 1 1 1 
1 1 1 1 1 1 1 1 1 1 1 1 1 1 1 1 1 1 1 1 1 1 1 1 1 1 1 1 1 1 1 1 1 1 1 1 1 1 1 1 1 1 1 1 1 1 1 1 1 1 
1 1 1 1 1 1 1 1 1 1 1 1 1 1 1 1 1 1 1 1 1 1 1 1 1 1 1 1 1 1 1 1 1 1 1 1 1 1 1 1 1 1 1 1 1 1 1 1 1 1 
1 1 1 1 1 1 1 1 1 1 1 1 1 1 1 1 1 1 1 1 1 1 1 1 1 1 1 1 1 1 1 1 1 1 1 1 1 1 1 1 1 1 1 1 1 1 1 1 1 1 
1 1 1 1 1 1 1 1 1 1 1 1 1 1 1 1 1 1 1 1 1 1 1 1 1 1 1 1 1 1 1 1 1 1 1 1 1 1 1 1 1 1 1 1 1 1 1 1 1 1 
