1 1 1 1 1 1 1 1 1 1 1 1 1 1 1 1 1 1 1 1 1 1 1 1 1 1 1 1 1 1 1 1 1 1 1 1 1 1 1 1 1 1 1 1 1 1 1 1 1 1 
1 1 1 1 1 1 1 1 1 1 1 1 1 1 1 1 1 1 1 1 1 1 1 1 1 1 1 1 1 1 1 1 1 1 1 1 1 1 1 1 1 1 1 1 1 1 1 1 1 1 
1 1 1 1 1 1 1 1 1 1 1 1 1 1 1 1 1 1 1 1 1 1 1 1 1 1 1 1 1 1 1 1 1 1 1 1 1 1 1 1 1 1 1 1 1 1 1 1 1 1 
1 1 1 1 1 1 1 1 1 1 1 1 1 1 1 1 1 1 1 1 1 1 1 1 1 1 1 1 1 1 1 1 1 1 1 1 1 1 1 1 1 1 1 1 1 1 1 1 1 1 
1 1 1 1 1 1 1 1 1 1 1 1 1 1 1 1 1 1 1 1 1 1 1 1 3 1 1 3 1 1 1 1 1 1 1 1 1 1 1 1 1 1 1 1 1 1 1 1 1 1 
1 1 1 1 1 1 1 1 1 1 1 1 1 1 1 1 4 1 1 1 1 1 1 1 1 1 1 1 1 1 1 1 1 1 1 1 1 1 1 1 1 1 1 1 1 1 1 1 1 1 
1 1 1 1 1 1 1 29 27 27 27 27 27 28 1 1 1 1 1 4 1 1 1 1 1 1 1 1 1 29 27 27 27 27 28 1 1 29 27 27 27 27 28 1 1 1 1 1 1 1 
1 1 1 1 1 1 29 24 1 1 1 1 1 25 27 28 1 3 1 1 3 4 1 1 1 1 1 1 1 33 82 88 83 78 25 27 27 24 78 4 4 4 25 28 1 1 1 1 1 1 
1 1 1 1 1 1 33 79 46 44 44 44 45 1 4 25 27 27 27 28 1 1 1 1 1 1 1 1 1 33 84 89 85 77 101 1 1 75 77 75 1 73 4 26 1 1 1 1 1 1 
1 1 1 1 1 1 33 80 50 36 43 43 41 44 44 44 45 78 1 25 27 27 28 1 1 1 1 1 1 33 86 90 87 4 102 1 1 1 72 1 5 3 78 26 1 1 1 1 1 1 
1 1 1 1 1 1 33 77 50 43 43 43 43 43 43 43 42 77 1 1 4 73 26 1 1 1 1 1 29 24 17 15 16 1 74 1 2 1 78 8 2 74 77 26 1 1 1 1 1 1 
1 1 1 1 1 1 32 22 50 43 106 106 106 106 106 43 42 1 78 1 1 1 25 27 27 28 1 1 33 4 21 14 13 75 1 8 1 1 77 4 78 78 23 31 1 1 1 1 1 1 
1 1 1 1 1 1 1 33 50 43 37 43 43 43 36 43 42 1 77 1 1 1 1 1 78 26 1 1 33 4 21 14 12 15 15 15 15 15 15 16 80 77 26 1 1 1 1 1 1 1 
1 1 1 1 1 1 1 33 50 43 43 43 81 52 52 52 53 1 1 1 72 1 1 79 77 26 1 1 33 4 21 14 14 14 14 14 14 14 14 13 80 23 31 1 1 1 1 1 1 1 
1 1 1 1 1 1 1 33 50 43 43 36 43 43 43 43 42 1 1 71 1 1 1 77 1 26 1 1 32 22 20 18 9 14 10 18 18 9 14 13 80 26 1 1 1 1 1 1 1 1 
1 1 1 1 1 1 1 33 50 43 106 106 106 106 106 43 42 4 1 1 1 1 1 1 8 25 28 1 1 33 4 74 21 14 13 72 4 21 14 13 80 26 1 1 1 1 1 1 1 1 
1 1 1 1 1 1 29 24 49 47 47 47 38 43 43 36 42 4 4 74 1 1 1 1 1 4 26 1 1 33 4 8 21 14 13 77 78 21 14 13 77 25 28 1 1 1 1 1 1 1 
1 1 1 1 1 1 33 4 4 4 4 4 49 47 47 47 48 4 4 4 1 1 1 1 1 1 26 1 1 33 4 1 21 14 13 75 77 21 14 12 15 16 26 1 1 1 1 1 1 1 
1 1 1 1 1 1 33 4 4 4 4 4 4 4 4 4 4 4 4 4 4 1 1 1 75 1 26 1 1 33 6 75 21 14 13 78 74 21 14 14 14 13 26 1 1 1 1 1 1 1 
1 1 1 1 1 1 33 4 4 4 4 4 4 4 4 4 4 4 4 4 4 4 1 17 15 16 26 1 1 33 72 1 21 14 13 77 4 20 18 9 14 13 26 1 1 1 1 1 1 1 
1 1 1 1 1 1 32 30 22 4 4 4 4 4 4 4 4 4 4 4 4 4 4 21 14 13 26 1 1 32 30 22 21 14 13 23 30 30 22 21 14 13 26 1 1 1 1 1 1 1 
1 1 1 1 1 1 1 1 32 30 30 30 30 30 30 30 30 30 30 30 30 30 22 21 14 13 26 1 1 1 1 33 21 14 13 26 1 1 33 21 14 13 26 1 1 1 1 1 1 1 
1 1 1 1 1 1 1 1 75 2 72 4 5 78 8 4 73 3 4 2 79 4 33 21 14 13 26 1 1 1 1 33 21 14 13 26 1 1 33 21 14 13 26 1 1 1 1 1 1 1 
1 1 1 1 1 1 1 1 1 1 4 3 4 77 4 74 4 5 4 8 77 29 24 21 14 13 26 1 1 1 1 33 21 14 13 26 1 1 33 21 14 13 26 1 1 1 29 27 27 27 
1 1 1 1 1 1 1 1 2 29 27 27 27 27 27 27 27 27 27 27 27 24 6 21 14 13 26 1 1 1 1 33 21 14 13 26 1 1 33 21 14 13 25 27 27 27 24 4 4 4 
1 1 1 1 1 1 1 1 29 24 17 15 15 15 15 15 15 15 15 15 15 15 15 11 14 13 26 1 1 29 27 24 21 14 13 26 1 1 33 21 14 12 15 15 15 15 15 15 15 15 
1 1 1 1 1 1 1 29 24 1 21 14 14 14 14 14 14 14 14 14 14 14 14 14 14 13 26 1 1 33 1 1 21 14 13 26 1 1 33 21 14 14 14 14 14 14 14 14 14 14 
1 1 1 1 1 1 1 33 1 1 21 14 10 18 18 18 18 18 18 18 18 18 18 18 18 19 26 1 1 33 1 78 21 14 13 26 1 1 33 20 18 18 18 18 18 18 18 18 18 18 
1 1 1 1 1 1 1 32 22 1 21 14 13 79 1 1 1 4 1 1 1 1 1 1 4 23 31 1 1 33 1 77 21 14 13 26 1 1 32 30 30 30 30 30 30 30 22 4 4 4 
1 1 1 1 1 1 1 1 33 1 21 14 13 80 46 44 44 44 44 44 44 44 44 44 45 26 1 1 29 24 1 75 21 14 13 25 28 1 1 1 1 1 1 1 1 1 32 30 30 30 
1 1 1 1 1 1 1 1 33 1 21 14 13 80 50 43 43 43 43 43 43 43 43 43 42 26 1 1 33 1 4 73 21 14 13 4 25 28 1 1 1 1 1 1 1 1 1 1 1 1 
1 1 1 1 1 1 1 1 33 8 21 14 13 77 50 43 36 43 39 47 38 43 37 43 42 26 1 1 33 8 1 1 21 14 12 15 16 25 28 1 1 1 1 1 1 1 1 1 1 1 
1 1 1 1 1 1 1 1 33 1 21 14 13 1 50 43 43 43 42 5 50 43 43 43 42 25 28 1 32 22 74 1 21 14 14 14 13 4 25 27 27 27 27 28 1 1 1 1 1 1 
1 1 1 1 1 1 1 29 24 1 21 14 13 8 50 43 43 37 41 54 40 43 43 43 42 79 26 1 1 33 1 4 20 18 9 14 12 15 15 15 15 16 78 26 1 1 1 1 1 1 
1 1 1 1 1 1 1 33 3 74 21 14 13 4 50 43 43 43 43 55 43 43 43 36 42 80 26 1 1 33 79 1 74 4 21 14 14 14 14 14 14 13 77 26 1 1 1 1 1 1 
1 1 1 1 1 1 29 24 1 1 21 14 13 4 49 47 47 47 47 56 47 47 47 47 48 80 26 1 1 33 77 75 4 4 21 14 10 18 18 18 18 19 23 31 1 1 1 1 1 1 
1 1 1 1 1 1 33 74 1 1 21 14 13 4 4 4 1 1 1 1 4 4 4 1 1 77 25 27 27 24 8 4 4 4 21 14 13 79 78 1 78 79 26 1 1 1 1 1 1 1 
1 1 1 1 1 1 33 73 1 2 21 14 12 15 15 15 15 15 15 15 15 15 15 15 15 15 15 15 15 15 15 15 15 15 11 14 13 80 77 1 77 80 26 1 1 1 1 1 1 1 
1 1 1 1 1 1 32 22 1 74 21 14 14 14 14 14 14 14 14 14 14 14 14 14 14 14 14 14 14 14 14 14 14 14 14 14 13 77 4 1 4 77 26 1 1 1 1 1 1 1 
1 1 1 1 1 1 1 33 75 1 20 18 18 18 18 18 18 18 18 18 18 18 18 18 18 18 18 18 18 18 18 18 18 18 18 18 19 78 4 1 4 4 25 28 1 1 1 1 1 1 
1 1 1 1 1 1 1 32 22 1 1 1 1 75 74 2 1 1 75 1 2 23 30 30 30 30 30 30 30 22 4 4 4 78 4 78 4 80 7 1 75 4 4 26 1 1 1 1 1 1 
1 1 1 1 1 1 1 1 32 22 3 1 1 72 73 1 23 30 30 30 30 31 1 1 1 1 1 1 1 32 30 30 22 77 4 77 4 77 74 1 7 4 23 31 1 1 1 1 1 1 
1 1 1 1 1 1 1 1 1 32 22 74 75 23 30 30 31 1 1 1 1 1 1 1 1 1 1 1 1 1 1 1 32 30 30 30 30 30 22 75 74 23 31 1 1 1 1 1 1 1 
1 1 1 1 1 1 1 1 1 1 32 30 30 31 1 1 1 1 1 1 1 1 1 1 1 1 1 1 1 1 1 1 1 1 1 1 1 1 32 30 30 31 1 1 1 1 1 1 1 1 
1 1 1 1 1 1 1 1 1 1 1 1 1 1 1 1 1 1 1 1 1 1 1 1 1 1 1 1 1 1 1 1 1 1 1 1 1 1 1 1 1 1 1 1 1 1 1 1 1 1 
1 1 1 1 1 1 1 1 1 1 1 1 1 1 1 1 1 1 1 1 1 1 1 1 1 1 1 1 1 1 1 1 1 1 1 1 1 1 1 1 1 1 1 1 1 1 1 1 1 1 
1 1 1 1 1 1 1 1 1 1 1 1 1 1 1 1 1 1 1 1 1 1 1 1 1 1 1 1 1 1 1 1 1 1 1 1 1 1 1 1 1 1 1 1 1 1 1 1 1 1 
1 1 1 1 1 1 1 1 1 1 1 1 1 1 1 1 1 1 1 1 1 1 1 1 1 1 1 1 1 1 1 1 1 1 1 1 1 1 1 1 1 1 1 1 1 1 1 1 1 1 
1 1 1 1 1 1 1 1 1 1 1 1 1 1 1 1 1 1 1 1 1 1 1 1 1 1 1 1 1 1 1 1 1 1 1 1 1 1 1 1 1 1 1 1 1 1 1 1 1 1 
1 1 1 1 1 1 1 1 1 1 1 1 1 1 1 1 1 1 1 1 1 1 1 1 1 1 1 1 1 1 1 1 1 1 1 1 1 1 1 1 1 1 1 1 1 1 1 1 1 1 
