118 120 73 1 1 1 1 1 1 1 1 118 120 4 1 1 1 2 73 33 50 43 43 43 42 26 1 1 79 1 1 1 2 1 1 1 77 1 1 1 1 1 73 1 1 1 1 1 1 1 
119 121 4 1 1 1 3 118 120 1 1 119 121 118 120 122 1 1 8 33 50 43 124 43 42 25 28 4 77 1 1 1 1 1 1 3 1 1 1 79 1 1 1 1 1 1 1 78 1 1 
4 1 8 2 1 72 122 119 121 4 1 1 4 119 121 1 4 118 120 33 50 43 43 43 41 45 26 1 4 1 1 73 1 78 1 1 1 1 4 77 1 1 1 78 1 1 4 77 1 1 
1 122 118 120 1 1 1 4 1 8 1 4 72 122 3 1 1 119 121 33 49 38 43 36 43 42 26 1 1 79 1 1 1 77 4 1 1 2 1 4 1 72 4 77 1 1 1 79 1 1 
1 1 119 121 1 118 120 1 1 2 1 118 120 1 1 4 1 4 1 33 5 50 43 43 43 42 26 1 3 77 4 1 1 1 1 1 1 1 1 1 1 1 1 1 1 1 1 77 4 1 
120 1 4 1 4 119 121 72 1 122 4 119 121 1 2 118 120 73 1 33 46 40 43 43 43 42 26 1 1 4 1 1 72 1 1 73 1 1 1 79 1 1 3 1 1 1 1 4 1 1 
121 1 122 1 8 3 1 1 118 120 1 1 1 8 4 119 121 1 122 33 50 43 37 43 39 48 25 27 28 1 1 1 1 1 1 1 1 1 1 77 4 1 1 1 1 2 1 1 1 1 
4 1 1 1 2 1 1 1 119 121 29 27 27 27 27 27 27 27 27 24 50 106 43 43 42 1 122 1 25 27 27 27 27 27 27 27 28 1 1 4 1 1 1 78 4 1 73 1 79 1 
2 1 4 1 1 1 118 120 73 29 24 4 78 4 4 79 4 4 79 4 50 43 43 43 42 1 1 1 1 4 118 120 1 1 1 1 25 27 27 27 28 1 1 77 1 1 1 4 77 1 
8 1 118 120 1 122 119 121 29 24 78 2 77 4 4 77 1 1 80 46 40 43 43 39 48 118 120 1 1 1 119 121 1 1 1 1 1 1 1 1 26 1 72 1 1 3 1 1 4 1 
1 4 119 121 1 1 4 29 24 4 77 1 4 1 2 1 1 4 80 50 43 36 43 42 1 119 121 4 1 2 1 1 1 118 120 4 1 1 1 2 26 1 1 1 1 1 1 1 1 1 
1 1 8 2 1 118 120 33 4 78 1 3 123 1 4 4 4 1 80 50 43 43 43 41 45 1 118 120 1 1 1 1 4 119 121 1 1 122 1 1 25 27 28 2 1 1 72 1 1 1 
120 1 122 1 4 119 121 33 4 77 4 1 4 1 1 3 1 1 80 49 38 43 124 43 41 45 119 121 1 1 4 1 1 1 2 1 1 1 1 3 1 1 26 1 1 1 1 1 1 1 
121 1 1 4 1 1 72 32 22 4 4 1 4 4 4 4 4 4 77 4 49 38 43 43 43 41 45 1 122 118 120 1 1 1 1 4 1 1 1 1 1 1 26 1 1 79 1 1 2 1 
8 4 1 118 120 2 1 1 33 78 1 2 4 17 15 15 15 15 15 15 16 49 38 43 37 43 42 1 1 119 121 1 3 1 122 118 120 1 1 1 1 1 26 1 1 77 4 1 1 78 
2 1 3 119 121 8 118 120 33 80 1 4 78 21 35 14 14 14 14 34 13 1 51 52 52 52 53 1 1 1 4 1 1 1 4 119 121 1 1 1 4 1 26 1 1 4 1 1 4 77 
1 122 4 1 1 122 119 121 33 80 1 4 77 21 14 10 18 18 18 18 19 46 40 43 43 43 42 1 2 1 1 1 1 1 1 1 1 1 118 120 1 1 26 1 1 1 1 1 1 1 
1 1 118 120 1 1 4 1 33 80 1 2 3 21 14 13 7 1 1 1 46 40 43 43 43 43 42 118 120 1 122 1 4 1 1 1 1 4 119 121 1 1 26 1 73 1 3 1 1 2 
1 72 119 121 1 3 1 29 24 77 4 4 4 21 14 13 1 8 72 1 50 43 43 36 43 39 48 119 121 4 1 1 118 120 4 1 3 1 4 1 122 1 25 28 1 1 79 1 1 1 
118 120 1 1 1 118 120 33 1 8 1 73 1 21 14 13 1 3 1 73 50 43 43 43 39 48 1 4 1 1 1 1 119 121 1 1 1 1 1 1 1 1 4 26 1 1 77 4 1 1 
119 121 1 122 73 119 121 33 72 3 7 2 1 21 34 13 1 1 7 1 50 43 43 43 42 118 120 1 3 118 120 1 4 1 1 122 1 1 4 1 1 1 4 26 1 1 4 1 1 73 
120 4 2 1 4 1 1 33 1 1 1 1 4 21 14 13 4 8 1 1 50 43 36 43 42 119 121 4 1 119 121 1 1 1 2 1 4 118 120 1 1 2 4 26 1 2 1 1 1 1 
121 73 1 8 118 120 29 24 2 8 125 4 4 21 14 13 4 4 1 1 49 38 43 124 41 45 1 1 1 4 1 4 1 1 1 1 1 119 121 1 1 1 4 26 1 29 27 27 27 27 
27 27 27 28 119 121 33 1 7 1 4 4 4 21 14 13 4 4 4 7 1 50 43 43 43 41 45 1 46 44 44 44 45 4 1 4 46 44 44 44 44 44 45 25 27 24 46 44 44 44 
4 4 4 25 27 27 24 73 1 4 4 4 4 21 14 13 4 4 4 4 8 49 38 43 43 43 41 44 40 43 43 43 41 44 54 44 40 43 43 43 43 43 41 44 44 44 40 43 43 43 
15 15 15 15 15 15 15 15 15 15 15 15 15 11 14 12 15 15 15 15 16 1 50 43 43 43 43 43 43 43 37 43 43 43 55 43 43 43 43 36 43 43 43 43 43 43 43 43 37 43 
14 14 34 14 14 14 35 14 14 14 14 34 14 14 35 14 14 14 14 34 13 125 50 43 37 124 36 43 43 43 43 43 36 43 55 43 43 43 43 43 43 43 37 43 43 36 43 43 43 43 
18 18 18 18 18 18 18 18 18 18 18 18 18 9 14 10 18 18 18 18 19 1 50 43 43 43 43 43 39 47 47 38 43 43 55 43 43 37 39 47 38 43 43 43 43 43 39 47 47 47 
4 4 4 23 30 30 22 1 1 4 4 4 4 21 14 13 4 4 4 4 1 46 40 43 43 43 39 47 48 1 1 49 47 47 56 47 47 47 48 70 49 47 47 47 47 47 48 23 30 30 
30 30 30 31 118 120 33 1 72 1 4 4 4 21 14 13 4 4 4 1 8 50 43 43 36 43 42 2 1 1 1 1 2 17 15 16 1 1 1 1 1 1 1 23 30 30 30 31 118 120 
120 8 2 4 119 121 33 7 1 1 1 4 4 21 14 13 4 4 72 1 46 40 43 43 43 39 48 1 1 1 3 1 1 21 34 13 78 4 4 72 4 4 78 26 1 4 118 120 119 121 
121 122 1 1 73 1 33 1 1 1 1 1 4 21 14 13 4 1 1 3 50 43 43 43 39 48 1 1 1 5 1 72 1 21 14 13 77 1 1 1 1 3 77 26 1 2 119 121 122 1 
1 3 118 120 1 1 32 22 2 1 1 1 1 21 34 13 1 7 1 1 50 36 43 43 42 1 3 1 8 118 120 1 1 21 14 13 78 1 2 1 74 1 78 26 118 120 8 1 1 4 
72 1 119 121 4 8 122 33 1 1 125 1 1 21 14 13 1 8 2 1 50 43 124 43 41 45 1 1 1 119 121 8 1 21 14 13 77 1 1 126 8 1 80 26 119 121 1 4 1 1 
1 1 1 1 2 118 120 33 1 7 1 1 78 21 14 13 78 1 1 1 49 38 43 43 43 41 45 1 73 1 5 1 1 21 14 13 3 1 123 71 127 1 80 26 1 118 120 122 1 2 
8 2 4 1 1 119 121 33 1 1 8 3 77 21 14 13 77 4 1 7 1 50 43 43 43 43 42 2 1 1 1 1 2 21 14 13 78 1 73 123 1 1 80 26 8 119 121 1 1 1 
118 120 122 1 72 4 1 32 22 1 1 1 4 21 14 12 15 15 15 15 16 49 38 43 43 36 42 17 15 15 15 15 15 11 14 13 77 1 1 1 75 2 77 26 4 3 72 4 1 1 
119 121 1 3 1 1 1 4 33 1 1 1 1 21 35 14 14 34 14 14 13 1 50 43 43 81 53 21 14 34 14 14 14 14 35 13 78 74 2 1 1 1 78 26 122 1 1 1 1 1 
1 1 2 1 1 1 118 120 33 1 2 1 78 20 18 18 18 18 18 18 19 46 40 43 43 43 42 20 18 18 18 18 18 9 14 13 77 4 4 1 4 4 77 26 118 120 8 1 1 1 
1 8 1 1 122 4 119 121 33 1 1 1 77 4 1 1 8 1 79 1 1 50 37 43 43 39 48 2 1 78 3 1 1 21 14 13 1 1 1 1 1 23 30 31 119 121 1 2 1 1 
1 1 1 118 120 1 1 122 33 1 8 1 1 1 125 7 1 4 77 4 1 50 43 43 43 42 1 4 1 77 1 2 78 21 14 13 1 3 1 23 30 31 1 8 1 122 4 1 1 1 
1 2 4 119 121 72 3 1 32 30 30 22 3 1 1 1 1 1 2 1 46 40 43 124 43 42 23 30 30 30 30 22 77 21 34 13 1 23 30 31 1 118 120 4 1 1 1 1 1 1 
8 1 73 1 1 1 1 118 120 2 8 32 30 30 30 30 30 22 1 78 50 43 43 43 43 42 26 8 1 1 1 32 22 21 14 13 23 31 118 120 2 119 121 72 1 8 1 1 2 1 
1 122 118 120 4 122 1 119 121 4 118 120 1 1 122 118 120 32 22 77 50 43 43 43 39 48 26 118 120 4 1 2 33 21 14 13 26 4 119 121 1 4 3 118 120 1 1 1 1 1 
1 1 119 121 8 1 1 4 118 120 119 121 118 120 4 119 121 2 33 4 50 43 43 36 42 23 31 119 121 1 122 1 33 21 35 13 26 1 8 1 122 1 1 119 121 4 1 1 1 1 
1 1 1 1 1 2 1 1 119 121 8 2 119 121 1 122 8 73 33 46 40 43 43 43 42 26 1 4 1 3 118 120 33 21 14 13 26 122 118 120 1 1 4 1 1 1 1 1 1 1 
1 1 1 1 1 1 1 1 1 1 1 1 1 1 1 1 1 1 33 50 43 43 37 43 42 26 122 1 72 1 119 121 33 21 14 13 26 2 119 121 4 8 1 1 2 1 1 2 1 1 
1 1 1 1 1 1 1 1 1 1 1 1 1 1 1 1 118 120 33 50 43 43 43 39 48 26 2 118 120 1 1 4 33 21 14 13 26 118 120 1 1 118 120 4 1 1 1 1 1 1 
1 1 1 1 1 1 1 1 1 1 1 1 1 1 1 1 119 121 33 50 43 124 43 42 23 31 1 119 121 122 1 8 33 21 14 13 26 119 121 8 122 119 121 1 1 1 1 1 1 1 
1 1 1 1 1 1 1 1 1 1 1 1 1 1 1 118 120 1 33 50 43 43 43 42 26 1 4 1 73 1 1 1 33 21 34 13 26 1 1 4 1 1 1 4 1 1 1 1 1 1 
