1 1 1 1 1 1 1 1 1 1 1 1 1 1 1 1 1 1 1 33 50 43 43 43 42 26 1 1 1 1 1 1 1 1 1 1 1 1 1 1 1 1 1 1 1 1 1 1 1 1 
1 1 1 1 1 1 1 1 1 1 1 1 1 1 1 1 1 1 1 33 50 43 124 43 42 25 28 1 1 1 1 1 1 1 1 1 1 1 1 1 1 1 1 1 1 1 1 1 1 1 
1 1 1 1 1 1 1 1 1 1 1 1 1 1 1 1 1 1 1 33 50 43 43 43 41 45 26 1 1 1 1 1 1 1 1 1 1 1 1 1 1 1 1 1 1 1 1 1 1 1 
1 1 1 1 1 1 1 1 1 1 1 1 1 1 1 1 1 1 1 33 49 38 43 43 43 42 26 1 1 1 1 1 1 1 1 1 1 1 1 1 1 1 1 1 1 1 1 1 1 1 
1 1 1 1 1 1 1 1 1 1 1 1 1 1 1 1 1 1 1 33 5 50 43 43 43 42 26 1 1 1 1 1 1 1 1 1 1 1 1 1 1 1 1 1 1 1 1 1 1 1 
1 1 1 1 1 1 1 1 1 1 1 1 1 1 1 1 1 1 1 33 46 40 43 43 43 42 26 1 1 1 1 1 1 1 1 1 1 1 1 1 1 1 1 1 1 1 1 1 1 1 
1 1 1 1 1 1 1 1 1 1 1 1 1 1 1 1 1 1 1 33 50 43 43 43 39 48 25 27 28 1 1 1 1 1 1 1 1 1 1 1 1 1 1 1 1 1 1 1 1 1 
1 1 1 1 1 1 1 1 1 1 29 27 27 27 27 27 27 27 27 24 50 106 43 43 42 1 122 1 25 27 27 27 27 27 27 27 28 1 1 1 1 1 1 1 1 1 1 1 1 1 
1 1 1 1 1 1 1 1 1 29 24 4 78 4 4 79 4 4 79 4 50 43 43 43 42 1 1 1 1 4 118 120 1 1 1 1 25 27 27 27 28 1 1 1 1 1 1 1 1 1 
1 1 1 1 1 1 1 1 29 24 78 1 77 4 4 77 1 1 80 46 40 43 43 39 48 118 120 1 1 1 119 121 1 1 1 1 1 1 1 1 26 1 1 1 1 1 1 1 1 1 
1 1 1 1 1 1 1 29 24 4 77 1 4 1 1 1 1 4 80 50 43 43 43 42 1 119 121 4 1 2 1 1 1 118 120 4 1 1 1 2 26 1 1 1 1 1 1 1 1 1 
1 1 1 1 1 1 1 33 4 78 1 1 123 1 4 4 4 1 80 50 43 43 43 41 45 1 118 120 1 1 1 1 4 119 121 1 1 122 1 1 25 27 28 1 1 1 1 1 1 1 
1 1 1 1 1 1 1 33 4 77 4 1 4 1 1 1 1 1 80 49 38 43 124 43 41 45 119 121 1 1 4 1 1 1 2 1 1 1 1 3 1 1 26 1 1 1 1 1 1 1 
1 1 1 1 1 1 1 32 22 4 4 1 4 4 4 4 4 4 77 4 49 38 43 43 43 41 45 1 122 118 120 1 1 1 1 4 1 1 1 1 1 1 26 1 1 1 1 1 1 1 
1 1 1 1 1 1 1 1 33 78 1 1 4 17 15 15 15 15 15 15 16 49 38 43 43 43 42 1 1 119 121 1 3 1 122 118 120 1 1 1 1 1 26 1 1 1 1 1 1 1 
1 1 1 1 1 1 1 1 33 80 1 4 78 21 14 14 14 14 14 14 13 1 51 52 52 52 53 1 1 1 4 1 1 1 4 119 121 1 1 1 4 1 26 1 1 1 1 1 1 1 
1 1 1 1 1 1 1 1 33 80 1 4 77 21 14 10 18 18 18 18 19 46 40 43 43 43 42 1 2 1 1 1 1 1 1 1 1 1 118 120 1 1 26 1 1 1 1 1 1 1 
1 1 1 1 1 1 1 1 33 80 1 1 1 21 14 13 1 1 1 1 46 40 43 43 43 43 42 118 120 1 122 1 4 1 1 1 1 4 119 121 1 1 26 1 1 1 1 1 1 1 
1 1 1 1 1 1 1 29 24 77 4 4 4 21 14 13 1 1 1 1 50 43 43 43 43 39 48 119 121 4 1 1 118 120 4 1 3 1 4 1 122 1 25 28 1 1 1 1 1 1 
1 1 1 1 1 1 1 33 1 75 1 74 1 21 14 13 1 1 1 1 50 43 43 43 39 48 1 4 1 1 1 1 119 121 1 1 1 1 1 1 1 1 1 26 1 1 1 1 1 1 
1 1 1 1 1 1 1 33 74 3 6 2 1 21 14 13 1 1 1 1 50 43 43 43 42 118 120 1 3 118 120 1 4 1 1 122 1 1 4 1 1 1 1 26 1 1 1 1 1 1 
1 1 1 1 1 1 1 33 1 1 1 1 4 21 14 13 4 1 1 1 50 43 43 43 42 119 121 4 1 119 121 1 1 1 2 1 4 118 120 1 1 2 1 26 1 1 1 1 1 1 
1 1 1 1 1 1 29 24 2 75 125 4 4 21 14 13 4 4 1 1 49 38 43 124 41 45 1 1 1 4 1 4 1 1 1 1 1 119 121 1 1 1 1 26 1 29 27 27 27 27 
27 27 27 28 1 1 33 1 6 1 4 4 4 21 14 13 4 4 4 1 1 50 43 43 43 41 45 1 46 44 44 44 44 45 1 1 1 46 44 44 44 44 45 25 27 24 46 44 44 44 
4 4 4 25 27 27 24 74 1 4 4 4 4 21 14 13 4 4 4 4 1 49 38 43 43 43 41 44 40 43 43 43 43 41 44 54 44 40 43 43 43 43 41 44 44 44 40 43 43 43 
15 15 15 15 15 15 15 15 15 15 15 15 15 11 14 12 15 15 15 15 16 1 50 43 43 43 43 43 43 43 43 43 43 43 43 55 43 43 43 43 43 43 43 43 43 43 43 43 43 43 
14 14 14 14 14 14 14 14 14 14 14 14 14 14 14 14 14 14 14 14 13 125 50 43 43 124 43 43 43 43 43 43 43 43 43 55 43 43 43 43 43 43 43 43 43 43 43 43 43 43 
18 18 18 18 18 18 18 18 18 18 18 18 18 9 14 10 18 18 18 18 19 1 50 43 43 43 43 43 39 47 47 38 43 43 43 55 43 43 43 39 47 38 43 43 43 43 39 47 47 47 
4 4 4 23 30 30 22 1 1 4 4 4 4 21 14 13 4 4 4 4 1 46 40 43 43 43 39 47 48 1 1 49 47 47 47 56 47 47 47 48 1 49 47 47 47 47 48 23 30 30 
30 30 30 31 1 1 33 1 1 1 4 4 4 21 14 13 4 4 4 1 1 50 43 43 43 43 42 1 1 1 1 1 1 1 1 1 1 1 1 1 1 1 1 1 23 30 30 31 1 1 
1 1 1 1 1 1 33 1 1 1 1 4 4 21 14 13 4 4 1 1 46 40 43 43 43 39 48 1 1 1 1 1 1 1 1 1 1 1 1 1 1 1 1 1 26 1 1 1 1 1 
1 1 1 1 1 1 33 1 1 1 1 1 4 21 14 13 4 1 1 1 50 43 43 43 39 48 1 1 1 1 1 1 1 1 1 1 1 1 1 1 1 1 1 1 26 1 1 1 1 1 
1 1 1 1 1 1 32 22 1 1 1 1 1 21 14 13 1 1 1 1 50 43 43 43 42 1 1 1 1 1 1 1 1 1 1 1 1 1 1 1 1 1 1 1 26 1 1 1 1 1 
1 1 1 1 1 1 1 33 1 1 125 1 1 21 14 13 1 1 1 1 50 43 124 43 41 45 1 1 1 1 1 1 1 1 1 1 1 1 1 1 1 1 1 1 26 1 1 1 1 1 
1 1 1 1 1 1 1 33 1 1 1 1 1 21 14 13 78 1 1 1 49 38 43 43 43 41 45 1 1 1 1 1 1 1 1 1 1 1 1 1 1 1 1 1 26 1 1 1 1 1 
1 1 1 1 1 1 1 33 1 1 1 1 1 21 14 13 77 4 1 1 1 50 43 43 43 43 42 1 1 1 1 1 1 1 1 1 1 1 1 1 1 1 1 1 26 1 1 1 1 1 
1 1 1 1 1 1 1 32 22 1 1 1 78 21 14 12 15 15 15 15 16 49 38 43 43 43 42 1 1 1 1 1 1 1 1 1 1 1 1 1 1 1 1 1 26 1 1 1 1 1 
1 1 1 1 1 1 1 1 33 1 1 1 77 21 14 14 14 14 14 14 13 1 50 43 43 43 42 1 1 1 1 1 1 1 1 1 1 1 1 1 1 1 1 1 26 1 1 1 1 1 
1 1 1 1 1 1 1 1 33 1 1 1 4 21 14 10 18 18 18 18 19 46 40 43 43 43 42 1 1 1 1 1 1 1 1 1 1 1 1 1 1 1 1 1 26 1 1 1 1 1 
1 1 1 1 1 1 1 1 33 1 1 1 1 21 14 13 1 1 79 1 1 50 43 43 43 39 48 1 1 1 1 1 1 1 1 1 1 1 1 1 1 23 30 30 31 1 1 1 1 1 
1 1 1 1 1 1 1 1 33 1 1 1 1 21 14 13 1 4 77 4 1 50 43 43 43 42 1 1 1 1 1 1 1 1 1 1 1 1 1 23 30 31 1 1 1 1 1 1 1 1 
1 1 1 1 1 1 1 1 32 30 30 22 1 20 18 19 1 1 1 1 46 40 43 124 43 42 23 30 30 30 30 22 1 1 1 1 1 23 30 31 1 1 1 1 1 1 1 1 1 1 
1 1 1 1 1 1 1 1 1 1 1 32 30 30 30 30 30 22 1 1 50 43 43 43 43 42 26 1 1 1 1 32 22 17 15 16 23 31 1 1 1 1 1 1 1 1 1 1 1 1 
1 1 1 1 1 1 1 1 1 1 1 1 1 1 1 1 1 32 22 1 50 43 43 43 39 48 26 1 1 1 1 1 33 21 14 13 26 1 1 1 1 1 1 1 1 1 1 1 1 1 
1 1 1 1 1 1 1 1 1 1 1 1 1 1 1 1 1 1 33 1 50 43 43 43 42 23 31 1 1 1 1 1 33 21 14 13 26 1 1 1 1 1 1 1 1 1 1 1 1 1 
1 1 1 1 1 1 1 1 1 1 1 1 1 1 1 1 1 1 33 46 40 43 43 43 42 26 1 1 1 1 1 1 33 21 14 13 26 1 1 1 1 1 1 1 1 1 1 1 1 1 
1 1 1 1 1 1 1 1 1 1 1 1 1 1 1 1 1 1 33 50 43 43 43 43 42 26 1 1 1 1 1 1 33 21 14 13 26 1 1 1 1 1 1 1 1 1 1 1 1 1 
1 1 1 1 1 1 1 1 1 1 1 1 1 1 1 1 1 1 33 50 43 43 43 39 48 26 1 1 1 1 1 1 33 21 14 13 26 1 1 1 1 1 1 1 1 1 1 1 1 1 
1 1 1 1 1 1 1 1 1 1 1 1 1 1 1 1 1 1 33 50 43 124 43 42 23 31 1 1 1 1 1 1 33 21 14 13 26 1 1 1 1 1 1 1 1 1 1 1 1 1 
1 1 1 1 1 1 1 1 1 1 1 1 1 1 1 1 1 1 33 50 43 43 43 42 26 1 1 1 1 1 1 1 33 21 14 13 26 1 1 1 1 1 1 1 1 1 1 1 1 1 
