1 1 1 1 1 1 1 1 1 1 1 1 1 1 1 1 1 1 1 33 50 43 43 43 42 26 1 1 1 1 1 1 1 1 1 1 1 1 1 1 1 1 1 1 1 1 1 1 1 1 
1 1 1 1 1 1 1 1 1 1 1 1 1 1 1 1 1 1 1 33 50 43 124 43 42 25 28 1 1 1 1 1 1 1 1 1 1 1 1 1 1 1 1 1 1 1 1 1 1 1 
1 1 1 1 1 1 1 1 1 1 1 1 1 1 1 1 1 1 1 33 50 43 43 43 41 45 26 1 1 1 1 1 1 1 1 1 1 1 1 1 1 1 1 1 1 1 1 1 1 1 
1 1 1 1 1 1 1 1 1 1 1 1 1 1 1 1 1 1 1 33 49 38 43 43 43 42 26 1 1 1 1 1 1 1 1 1 1 1 1 1 1 1 1 1 1 1 1 1 1 1 
1 1 1 1 1 1 1 1 1 1 1 1 1 1 1 1 1 1 1 33 5 50 43 43 43 42 26 1 1 1 1 1 1 1 1 1 1 1 1 1 1 1 1 1 1 1 1 1 1 1 
1 1 1 1 1 1 1 1 1 1 1 1 1 1 1 1 1 1 1 33 46 40 43 43 43 42 26 1 1 1 1 1 1 1 1 1 1 1 1 1 1 1 1 1 1 1 1 1 1 1 
1 1 1 1 1 1 1 1 1 1 1 1 1 1 1 1 1 1 1 33 50 43 43 43 39 48 25 27 28 1 1 1 1 1 1 1 1 1 1 1 1 1 1 1 1 1 1 1 1 1 
1 1 1 1 1 1 1 1 1 1 29 27 27 27 27 27 27 27 27 24 50 106 43 43 42 1 1 1 25 27 27 27 27 27 27 27 28 1 1 1 1 1 1 1 1 1 1 1 1 1 
1 1 1 1 1 1 1 1 1 29 24 1 1 1 1 1 1 1 1 1 50 43 43 43 42 1 1 1 1 1 1 1 1 1 1 1 25 27 27 27 28 1 1 1 1 1 1 1 1 1 
1 1 1 1 1 1 1 1 29 24 1 1 1 1 1 1 1 1 1 46 40 43 43 39 48 1 1 1 1 1 1 1 1 1 1 1 1 1 1 1 26 1 1 1 1 1 1 1 1 1 
1 1 1 1 1 1 1 29 24 1 1 1 1 1 1 1 1 1 1 50 43 43 43 42 1 1 1 1 1 1 1 1 1 1 1 1 1 1 1 1 26 1 1 1 1 1 1 1 1 1 
1 1 1 1 1 1 1 33 1 1 1 1 1 1 1 1 1 1 1 50 43 43 43 41 45 1 1 1 1 1 1 1 1 1 1 1 1 1 1 1 25 27 28 1 1 1 1 1 1 1 
1 1 1 1 1 1 1 33 1 1 1 1 1 1 1 1 1 1 1 49 38 43 124 43 41 45 1 1 1 1 1 1 1 1 1 1 1 1 1 1 1 1 26 1 1 1 1 1 1 1 
1 1 1 1 1 1 1 32 22 1 1 1 1 1 1 1 1 1 1 1 49 38 43 43 43 41 45 1 1 1 1 1 1 1 1 1 1 1 1 1 1 1 26 1 1 1 1 1 1 1 
1 1 1 1 1 1 1 1 33 1 1 1 1 17 15 15 15 15 15 15 16 49 38 43 43 43 42 1 1 1 1 1 1 1 1 1 1 1 1 1 1 1 26 1 1 1 1 1 1 1 
1 1 1 1 1 1 1 1 33 1 1 1 1 21 14 14 14 14 14 14 13 1 51 52 52 52 53 1 1 1 1 1 1 1 1 1 1 1 1 1 1 1 26 1 1 1 1 1 1 1 
1 1 1 1 1 1 1 1 33 1 1 1 1 21 14 10 18 18 18 18 19 46 40 43 43 43 42 1 1 1 1 1 1 1 1 1 1 1 1 1 1 1 26 1 1 1 1 1 1 1 
1 1 1 1 1 1 1 1 33 1 1 1 1 21 14 13 1 1 1 1 46 40 43 43 43 43 42 1 1 1 1 1 1 1 1 1 1 1 1 1 1 1 26 1 1 1 1 1 1 1 
1 1 1 1 1 1 1 29 24 1 1 1 1 21 14 13 1 1 1 1 50 43 43 43 43 39 48 1 1 1 1 1 1 1 1 1 1 1 1 1 1 1 25 28 1 1 1 1 1 1 
1 1 1 1 1 1 1 33 1 1 1 1 1 21 14 13 1 1 1 1 50 43 43 43 39 48 1 1 1 1 1 1 1 1 1 1 1 1 1 1 1 1 1 26 1 1 1 1 1 1 
1 1 1 1 1 1 1 33 1 1 1 1 1 21 14 13 1 1 1 1 50 43 43 43 42 1 1 1 1 1 1 1 1 1 1 1 1 1 1 1 1 1 1 26 1 1 1 1 1 1 
1 1 1 1 1 1 1 33 1 1 1 1 1 21 14 13 1 1 1 1 50 43 43 43 42 1 1 1 1 1 1 1 1 1 1 1 1 1 1 1 1 1 1 26 1 1 1 1 1 1 
1 1 1 1 1 1 29 24 1 1 1 1 1 21 14 13 1 1 1 1 49 38 43 124 41 45 1 1 1 1 1 1 1 1 1 1 1 1 1 1 1 1 1 26 1 29 27 27 27 27 
27 27 27 28 1 1 33 1 1 1 1 1 1 21 14 13 1 1 1 1 1 50 43 43 43 41 45 1 46 44 44 44 44 45 1 1 1 46 44 44 44 44 45 25 27 24 46 44 44 44 
4 4 4 25 27 27 24 1 1 1 1 1 1 21 14 13 1 1 1 1 1 49 38 43 43 43 41 44 40 43 43 43 43 41 44 54 44 40 43 43 43 43 41 44 44 44 40 43 43 43 
15 15 15 15 15 15 15 15 15 15 15 15 15 11 14 12 15 15 15 15 16 1 50 43 43 43 43 43 43 43 43 43 43 43 43 55 43 43 43 43 43 43 43 43 43 43 43 43 43 43 
14 14 14 14 14 14 14 14 14 14 14 14 14 14 14 14 14 14 14 14 13 1 50 43 43 124 43 43 43 43 43 43 43 43 43 55 43 43 43 43 43 43 43 43 43 43 43 43 43 43 
18 18 18 18 18 18 18 18 18 18 18 18 18 9 14 10 18 18 18 18 19 1 50 43 43 43 43 43 39 47 47 38 43 43 43 55 43 43 43 39 47 38 43 43 43 43 39 47 47 47 
4 4 4 23 30 30 22 1 1 1 1 1 1 21 14 13 1 1 1 1 1 46 40 43 43 43 39 47 48 1 1 49 47 47 47 56 47 47 47 48 1 49 47 47 47 47 48 23 30 30 
30 30 30 31 1 1 33 1 1 1 1 1 1 21 14 13 1 1 1 1 1 50 43 43 43 43 42 1 1 1 1 1 1 1 1 1 1 1 1 1 1 1 1 1 23 30 30 31 1 1 
1 1 1 1 1 1 33 1 1 1 1 1 1 21 14 13 1 1 1 1 46 40 43 43 43 39 48 1 1 1 1 1 1 1 1 1 1 1 1 1 1 1 1 1 26 1 1 1 1 1 
1 1 1 1 1 1 33 1 1 1 1 1 1 21 14 13 1 1 1 1 50 43 43 43 39 48 1 1 1 1 1 1 1 1 1 1 1 1 1 1 1 1 1 1 26 1 1 1 1 1 
1 1 1 1 1 1 32 22 1 1 1 1 1 21 14 13 1 1 1 1 50 43 43 43 42 1 1 1 1 1 1 1 1 1 1 1 1 1 1 1 1 1 1 1 26 1 1 1 1 1 
1 1 1 1 1 1 1 33 1 1 1 1 1 21 14 13 1 1 1 1 50 43 124 43 41 45 1 1 1 1 1 1 1 1 1 1 1 1 1 1 1 1 1 1 26 1 1 1 1 1 
1 1 1 1 1 1 1 33 1 1 1 1 1 21 14 13 1 1 1 1 49 38 43 43 43 41 45 1 1 1 1 1 1 1 1 1 1 1 1 1 1 1 1 1 26 1 1 1 1 1 
1 1 1 1 1 1 1 33 1 1 1 1 1 21 14 13 1 1 1 1 1 50 43 43 43 43 42 1 1 1 1 1 1 1 1 1 1 1 1 1 1 1 1 1 26 1 1 1 1 1 
1 1 1 1 1 1 1 32 22 1 1 1 1 21 14 13 1 1 1 1 1 49 38 43 43 43 42 1 1 1 1 1 1 1 1 1 1 1 1 1 1 1 1 1 26 1 1 1 1 1 
1 1 1 1 1 1 1 1 33 1 1 1 1 21 14 13 1 1 1 1 1 1 50 43 43 43 42 1 1 1 1 1 1 1 1 1 1 1 1 1 1 1 1 1 26 1 1 1 1 1 
1 1 1 1 1 1 1 1 33 1 1 1 1 21 14 13 1 1 1 1 1 46 40 43 43 43 42 1 1 1 1 1 1 1 1 1 1 1 1 1 1 1 1 1 26 1 1 1 1 1 
1 1 1 1 1 1 1 1 33 1 1 1 1 21 14 13 1 1 1 1 1 50 43 43 43 39 48 1 1 1 1 1 1 1 1 1 1 1 1 1 1 23 30 30 31 1 1 1 1 1 
1 1 1 1 1 1 1 1 33 1 1 1 1 20 18 19 1 1 1 1 1 50 43 43 43 42 1 1 1 1 1 1 1 1 1 1 1 1 1 23 30 31 1 1 1 1 1 1 1 1 
1 1 1 1 1 1 1 1 32 30 30 22 1 1 1 1 1 1 1 1 46 40 43 124 43 42 23 30 30 30 30 22 1 1 1 1 1 23 30 31 1 1 1 1 1 1 1 1 1 1 
1 1 1 1 1 1 1 1 1 1 1 32 30 30 30 30 30 22 1 1 50 43 43 43 43 42 26 1 1 1 1 32 22 17 15 16 23 31 1 1 1 1 1 1 1 1 1 1 1 1 
1 1 1 1 1 1 1 1 1 1 1 1 1 1 1 1 1 32 22 1 50 43 43 43 39 48 26 1 1 1 1 1 33 21 14 13 26 1 1 1 1 1 1 1 1 1 1 1 1 1 
1 1 1 1 1 1 1 1 1 1 1 1 1 1 1 1 1 1 33 1 50 43 43 43 42 23 31 1 1 1 1 1 33 21 14 13 26 1 1 1 1 1 1 1 1 1 1 1 1 1 
1 1 1 1 1 1 1 1 1 1 1 1 1 1 1 1 1 1 33 46 40 43 43 43 42 26 1 1 1 1 1 1 33 21 14 13 26 1 1 1 1 1 1 1 1 1 1 1 1 1 
1 1 1 1 1 1 1 1 1 1 1 1 1 1 1 1 1 1 33 50 43 43 43 43 42 26 1 1 1 1 1 1 33 21 14 13 26 1 1 1 1 1 1 1 1 1 1 1 1 1 
1 1 1 1 1 1 1 1 1 1 1 1 1 1 1 1 1 1 33 50 43 43 43 39 48 26 1 1 1 1 1 1 33 21 14 13 26 1 1 1 1 1 1 1 1 1 1 1 1 1 
1 1 1 1 1 1 1 1 1 1 1 1 1 1 1 1 1 1 33 50 43 124 43 42 23 31 1 1 1 1 1 1 33 21 14 13 26 1 1 1 1 1 1 1 1 1 1 1 1 1 
1 1 1 1 1 1 1 1 1 1 1 1 1 1 1 1 1 1 33 50 43 43 43 42 26 1 1 1 1 1 1 1 33 21 14 13 26 1 1 1 1 1 1 1 1 1 1 1 1 1 
